"lang"
{
"Language"	"turkish"
"Tokens"
{
"TextEntry_Cut"	"Kes"
"[english]TextEntry_Cut"	"Cut"
"TextEntry_Copy"	"Kopyala"
"[english]TextEntry_Copy"	"Copy"
"TextEntry_Paste"	"Yapıştır"
"[english]TextEntry_Paste"	"Paste"
"TextEntry_SelectAll"	"Tümünü seç"
"[english]TextEntry_SelectAll"	"Select all"
"FileOpenDialog_Open"	"Aç"
"[english]FileOpenDialog_Open"	"Open"
"FileOpenDialog_Cancel"	"İptal"
"[english]FileOpenDialog_Cancel"	"Cancel"
"FileOpenDialog_Look_in"	"Göz at:"
"[english]FileOpenDialog_Look_in"	"Look in:"
"FileOpenDialog_File_Name"	"Dosya adı:"
"[english]FileOpenDialog_File_Name"	"File name:"
"FileOpenDialog_File_Type"	"Dosya türü:"
"[english]FileOpenDialog_File_Type"	"File type:"
"FileOpenDialog_Icon"	" "
"[english]FileOpenDialog_Icon"	" "
"FileOpenDialog_Name"	"İsim"
"[english]FileOpenDialog_Name"	"Name"
"FileOpenDialog_Type"	"Tür"
"[english]FileOpenDialog_Type"	"Type"
"SysMenu_Minimize"	" Küçült "
"[english]SysMenu_Minimize"	" Minimize "
"SysMenu_Maximize"	" Büyüt "
"[english]SysMenu_Maximize"	" Maximize "
"SysMenu_Close"	" Kapat "
"[english]SysMenu_Close"	" Close "
"Frame_Untitled"	"İsimsiz"
"[english]Frame_Untitled"	"Untitled"
"MessageBox_OK"	"Tamam"
"[english]MessageBox_OK"	"OK"
"PropertyDialog_OK"	"Tamam"
"[english]PropertyDialog_OK"	"OK"
"PropertyDialog_Cancel"	"İptal"
"[english]PropertyDialog_Cancel"	"Cancel"
"PropertyDialog_Apply"	"Uygula"
"[english]PropertyDialog_Apply"	"Apply"
"QueryBox_Cancel"	"İptal"
"[english]QueryBox_Cancel"	"Cancel"
"WizardPanel_Next"	"İLERİ >"
"[english]WizardPanel_Next"	"Next >"
"WizardPanel_Back"	"< GERİ"
"[english]WizardPanel_Back"	"< Back"
"WizardPanel_Finish"	"BİTİR"
"[english]WizardPanel_Finish"	"Finish"
"WizardPanel_Cancel"	"İptal"
"[english]WizardPanel_Cancel"	"Cancel"
"vgui_ok"	"TAMAM"
"[english]vgui_ok"	"OK"
"vgui_close"	"Kapat"
"[english]vgui_close"	"Close"
"vgui_Cancel"	"İptal"
"[english]vgui_Cancel"	"Cancel"
"vgui_select"	"Seç"
"[english]vgui_select"	"Select"
"vgui_createfolder"	"YENİ KLASÖR..."
"[english]vgui_createfolder"	"New Folder..."
"vgui_next"	"İLERİ >"
"[english]vgui_next"	"Next >"
"vgui_back"	"< GERİ"
"[english]vgui_back"	"< Back"
"vgui_CreateDirectoryFail_Title"	"Klasör Oluşturma - Hata"
"[english]vgui_CreateDirectoryFail_Title"	"Create Folder - Error"
"vgui_CreateDirectoryFail_Info"	"Klasör oluşturulamıyor, sürücü salt okunur."
"[english]vgui_CreateDirectoryFail_Info"	"Failed to create a folder, this drive is read-only."
"vgui_CreateDirectoryFail_AlreadyExists"	"Böyle bir klasör zaten mevcut."
"[english]vgui_CreateDirectoryFail_AlreadyExists"	"That folder already exists."
"TextEntry_Language"	"Dil"
"[english]TextEntry_Language"	"Language"
"TextEntry_ConversionMode"	"Dönüştürme Modu"
"[english]TextEntry_ConversionMode"	"Conversion Mode"
"TextEntry_SentenceMode"	"Karar Modu"
"[english]TextEntry_SentenceMode"	"Sentence Mode"
"IME_English"	"İngilizce"
"[english]IME_English"	"English"
"IME_Chinese"	"Çince"
"[english]IME_Chinese"	"Chinese"
"IME_Korean"	"Korece"
"[english]IME_Korean"	"Korean"
"IME_Hiragana"	"Hiragana"
"[english]IME_Hiragana"	"Hiragana"
"IME_FullWidthKatakana"	"Katakana (tam karakter)"
"[english]IME_FullWidthKatakana"	"Full-width Katakana"
"IME_FullWidthAlphanumeric"	"Alfanumerik (tam karakter)"
"[english]IME_FullWidthAlphanumeric"	"Full-width Alphanumeric"
"IME_HalfWidthKatakana"	"Katakana (indirgenmiş)"
"[english]IME_HalfWidthKatakana"	"Half-width Katakana"
"IME_HalfWidthAlphanumeric"	"Alfanumerik (indirgenmiş)"
"[english]IME_HalfWidthAlphanumeric"	"Half-width Alphanumeric"
"IME_General"	"Genel"
"[english]IME_General"	"General"
"IME_BiasNames"	"İsme Göre"
"[english]IME_BiasNames"	"Bias for Names"
"IME_BiasSpeech"	"Konuşma Biçimine Göre"
"[english]IME_BiasSpeech"	"Bias for Speech"
"IME_NoConversion"	"Dönüştürme Yok"
"[english]IME_NoConversion"	"No Conversion"
"IME_0404"	"Çince (Tayvan)"
"[english]IME_0404"	"Chinese (Taiwan)"
"IME_0804"	"Çince (Çin)"
"[english]IME_0804"	"Chinese (PRC)"
"IME_0409"	"İngilizce (A.B.D.)"
"[english]IME_0409"	"English (United States)"
"IME_0411"	"Japonca"
"[english]IME_0411"	"Japanese"
"IME_0412"	"Korece"
"[english]IME_0412"	"Korean"
"IME_0419"	"Rusça"
"[english]IME_0419"	"Russian"
"IME_041e"	"Tayca"
"[english]IME_041e"	"Thai"
"IME_040c"	"Fransızca (Standart)"
"[english]IME_040c"	"French (Standard)"
"IME_0407"	"Almanca (Standart)"
"[english]IME_0407"	"German (Standard)"
"IME_0410"	"Italyanca (Standart)"
"[english]IME_0410"	"Italian (Standard)"
"IME_040a"	"İspanyolca (İspanya, Geleneksel)"
"[english]IME_040a"	"Spanish (Spain, Traditional Sort)"
"vgui_FileCopyDialog_Title"	"Kopyalanıyor..."
"[english]vgui_FileCopyDialog_Title"	"Copying..."
"vgui_FileMoveDialog_Title"	"Taşınıyor..."
"[english]vgui_FileMoveDialog_Title"	"Moving..."
"vgui_FileCopy_Estimate"	"%s1 kaldı"
"[english]vgui_FileCopy_Estimate"	"%s1 remaining"
"vgui_FileCopy_Copying_Multiple"	"'%s1' kopyalanıyor (%s2 kaldı)"
"[english]vgui_FileCopy_Copying_Multiple"	"Copying '%s1' (%s2 remaining)"
"vgui_FileCopy_Copying_Single"	"'%s1' kopyalanıyor"
"[english]vgui_FileCopy_Copying_Single"	"Copying '%s1'"
"vgui_FileCopy_Ovewwrite_Title"	"Dosyaların üzerine yaz"
"[english]vgui_FileCopy_Ovewwrite_Title"	"Overwrite file(s)"
"vgui_FileCopy_Ovewwrite_Prompt"	"'%filename%' üzerine yazılsın mı?"
"[english]vgui_FileCopy_Ovewwrite_Prompt"	"Overwrite '%filename%'?"
"SMPEvent_AppLaunch"	"Uygulamayı Çalıştır"
"[english]SMPEvent_AppLaunch"	"App Launch"
"SMPEvent_AppExit"	"Uygulamadan Çık"
"[english]SMPEvent_AppExit"	"App Exit"
"SMPEvent_Close"	"Kapat"
"[english]SMPEvent_Close"	"Close"
"SMPEvent_FadeOut"	"Etkinliği Azalt"
"[english]SMPEvent_FadeOut"	"Fade Out"
"SMPEvent_MediaBegin"	"Medyayı Başlat"
"[english]SMPEvent_MediaBegin"	"Media Begin"
"SMPEvent_MediaEnd"	"Medyayı Bitir"
"[english]SMPEvent_MediaEnd"	"Media End"
"SMPEvent_Play"	"Oynat"
"[english]SMPEvent_Play"	"Play"
"SMPEvent_JumpHome"	"Başa Geç"
"[english]SMPEvent_JumpHome"	"Jump Home"
"SMPEvent_JumpEnd"	"Sona Geç"
"[english]SMPEvent_JumpEnd"	"Jump To End"
"SMPEvent_Pause"	"Duraklat"
"[english]SMPEvent_Pause"	"Pause"
"SMPEvent_Stop"	"Durdur"
"[english]SMPEvent_Stop"	"Stop"
"SMPEvent_JumpFrom"	"Geri Atla"
"[english]SMPEvent_JumpFrom"	"Scrub From"
"SMPEvent_JumpTo"	"İleri Atla"
"[english]SMPEvent_JumpTo"	"Scrub To"
"SMPEvent_StepFwd"	"Sonraki Adım"
"[english]SMPEvent_StepFwd"	"Step Forward"
"SMPEvent_StepBack"	"Önceki Adım"
"[english]SMPEvent_StepBack"	"Step Backwards"
"SMPEvent_JumpFwd"	"Sonrakine Geç"
"[english]SMPEvent_JumpFwd"	"Jump Forward"
"SMPEvent_JumpBack"	"Öncekine Dön"
"[english]SMPEvent_JumpBack"	"Jump Backwards"
"SMPEvent_Repeat"	"Tekrar Et"
"[english]SMPEvent_Repeat"	"Repeat"
"SMPEvent_Maximize"	"Büyüt"
"[english]SMPEvent_Maximize"	"Maximize"
"SMPEvent_Minimize"	"Küçült"
"[english]SMPEvent_Minimize"	"Minimize"
"SMPEvent_Restore"	"Geri Yükle"
"[english]SMPEvent_Restore"	"Restore"
"SMPStats_UserId"	"Kullanıcı Id:"
"[english]SMPStats_UserId"	"User Id:"
"SMPStats_Filename"	"Dosya Adı:"
"[english]SMPStats_Filename"	"Filename:"
"SMPStats_EventTitle"	"Durum"
"[english]SMPStats_EventTitle"	"Event"
"SMPStats_TimeTitle"	"Zaman (ms)"
"[english]SMPStats_TimeTitle"	"Time (ms)"
"SMPStats_PositionTitle"	"Pozisyon (ms)"
"[english]SMPStats_PositionTitle"	"Position (ms)"
"SMPStats_DialogTitle"	"Veri Koleksiyon Tercihleri"
"[english]SMPStats_DialogTitle"	"Data Collection Preferences"
"SMPStats_DontAskAgain"	"Bir daha sorma"
"[english]SMPStats_DontAskAgain"	"Don't ask again"
"vgui_Accept"	"Kabul Et"
"[english]vgui_Accept"	"Accept"
"vgui_Decline"	"Ret"
"[english]vgui_Decline"	"Decline"
"vgui_TimeLeftYearOrMore"	"1 yıldan daha fazla"
"[english]vgui_TimeLeftYearOrMore"	"more than 1 year"
"vgui_TimeLeftDay"	"%days% gün"
"[english]vgui_TimeLeftDay"	"%days% day"
"vgui_TimeLeftDays"	"%days% gün"
"[english]vgui_TimeLeftDays"	"%days% days"
"vgui_TimeLeftDayRemaining"	"%days% gün kaldı"
"[english]vgui_TimeLeftDayRemaining"	"%days% day remaining"
"vgui_TimeLeftDaysRemaining"	"%days% gün kaldı"
"[english]vgui_TimeLeftDaysRemaining"	"%days% days remaining"
"vgui_TimeLeftHour"	"%hours% saat"
"[english]vgui_TimeLeftHour"	"%hours% hour"
"vgui_TimeLeftHours"	"%hours% saat"
"[english]vgui_TimeLeftHours"	"%hours% hours"
"vgui_TimeLeftHourRemaining"	"%hours% saat kaldı"
"[english]vgui_TimeLeftHourRemaining"	"%hours% hour remaining"
"vgui_TimeLeftHoursRemaining"	"%hours% saat kaldı"
"[english]vgui_TimeLeftHoursRemaining"	"%hours% hours remaining"
"vgui_TimeLeftMinute"	"%minutes% dakika"
"[english]vgui_TimeLeftMinute"	"%minutes% minute"
"vgui_TimeLeftMinutes"	"%minutes% dakika"
"[english]vgui_TimeLeftMinutes"	"%minutes% minutes"
"vgui_TimeLeftMinuteRemaining"	"%minutes% dakika kaldı"
"[english]vgui_TimeLeftMinuteRemaining"	"%minutes% minute remaining"
"vgui_TimeLeftMinutesRemaining"	"%minutes% dakika kaldı"
"[english]vgui_TimeLeftMinutesRemaining"	"%minutes% minutes remaining"
"vgui_TimeLeftSecond"	"%seconds% saniye"
"[english]vgui_TimeLeftSecond"	"%seconds% second"
"vgui_TimeLeftSeconds"	"%seconds% saniye"
"[english]vgui_TimeLeftSeconds"	"%seconds% seconds"
"vgui_TimeLeftSecondRemaining"	"%seconds% saniye kaldı"
"[english]vgui_TimeLeftSecondRemaining"	"%seconds% second remaining"
"vgui_TimeLeftSecondsRemaining"	"%seconds% saniye kaldı"
"[english]vgui_TimeLeftSecondsRemaining"	"%seconds% seconds remaining"
"vgui_TimeLeftDaysHours"	"%days% gün %hours% saat"
"[english]vgui_TimeLeftDaysHours"	"%days% days %hours% hours"
"vgui_TimeLeftDaysHour"	"%days% gün %hours% saat"
"[english]vgui_TimeLeftDaysHour"	"%days% days %hours% hour"
"vgui_TimeLeftDayHours"	"%days% gün %hours% saat"
"[english]vgui_TimeLeftDayHours"	"%days% day %hours% hours"
"vgui_TimeLeftDayHour"	"%days% gün %hours% saat"
"[english]vgui_TimeLeftDayHour"	"%days% day %hours% hour"
"vgui_TimeLeftDaysHoursRemaining"	"%days% gün %hours% saat kaldı"
"[english]vgui_TimeLeftDaysHoursRemaining"	"%days% days %hours% hours remaining"
"vgui_TimeLeftDaysHourRemaining"	"%days% gün %hours% saat kaldı"
"[english]vgui_TimeLeftDaysHourRemaining"	"%days% days %hours% hour remaining"
"vgui_TimeLeftDayHoursRemaining"	"%days% gün %hours% saat kaldı"
"[english]vgui_TimeLeftDayHoursRemaining"	"%days% day %hours% hours remaining"
"vgui_TimeLeftDayHourRemaining"	"%days% gün %hours% saat kaldı"
"[english]vgui_TimeLeftDayHourRemaining"	"%days% day %hours% hour remaining"
"vgui_TimeLeftHoursMinutes"	"%hours% saat %minutes% dakika"
"[english]vgui_TimeLeftHoursMinutes"	"%hours% hours %minutes% minutes"
"vgui_TimeLeftHoursMinute"	"%hours% saat %minutes% dakika"
"[english]vgui_TimeLeftHoursMinute"	"%hours% hours %minutes% minute"
"vgui_TimeLeftHourMinutes"	"%hours% saat %minutes% dakika"
"[english]vgui_TimeLeftHourMinutes"	"%hours% hour %minutes% minutes"
"vgui_TimeLeftHourMinute"	"%hours% saat %minutes% dakika"
"[english]vgui_TimeLeftHourMinute"	"%hours% hour %minutes% minute"
"vgui_TimeLeftHoursMinutesRemaining"	"%hours% saat %minutes% dakika kaldı"
"[english]vgui_TimeLeftHoursMinutesRemaining"	"%hours% hours %minutes% minutes remaining"
"vgui_TimeLeftHoursMinuteRemaining"	"%hours% saat %minutes% dakika kaldı"
"[english]vgui_TimeLeftHoursMinuteRemaining"	"%hours% hours %minutes% minute remaining"
"vgui_TimeLeftHourMinutesRemaining"	"%hours% saat %minutes% dakika kaldı"
"[english]vgui_TimeLeftHourMinutesRemaining"	"%hours% hour %minutes% minutes remaining"
"vgui_TimeLeftHourMinuteRemaining"	"%hours% saat %minutes% dakika kaldı"
"[english]vgui_TimeLeftHourMinuteRemaining"	"%hours% hour %minutes% minute remaining"
"vgui_TimeLeftMinutesSeconds"	"%minutes% dakika %seconds% saniye"
"[english]vgui_TimeLeftMinutesSeconds"	"%minutes% minutes %seconds% seconds"
"vgui_TimeLeftMinutesSecond"	"%minutes% dakika %seconds% saniye"
"[english]vgui_TimeLeftMinutesSecond"	"%minutes% minutes %seconds% second"
"vgui_TimeLeftMinuteSeconds"	"%minutes% dakika %seconds% saniye"
"[english]vgui_TimeLeftMinuteSeconds"	"%minutes% minute %seconds% seconds"
"vgui_TimeLeftMinuteSecond"	"%minutes% dakika %seconds% saniye"
"[english]vgui_TimeLeftMinuteSecond"	"%minutes% minute %seconds% second"
"vgui_TimeLeftMinutesSecondsRemaining"	"%minutes% dakika %seconds% saniye kaldı"
"[english]vgui_TimeLeftMinutesSecondsRemaining"	"%minutes% minutes %seconds% seconds remaining"
"vgui_TimeLeftMinutesSecondRemaining"	"%minutes% dakika %seconds% saniye kaldı"
"[english]vgui_TimeLeftMinutesSecondRemaining"	"%minutes% minutes %seconds% second remaining"
"vgui_TimeLeftMinuteSecondsRemaining"	"%minutes% dakika %seconds% saniye kaldı"
"[english]vgui_TimeLeftMinuteSecondsRemaining"	"%minutes% minute %seconds% seconds remaining"
"vgui_TimeLeftMinuteSecondRemaining"	"%minutes% dakika %seconds% saniye kaldı"
"[english]vgui_TimeLeftMinuteSecondRemaining"	"%minutes% minute %seconds% second remaining"
"vgui_Today"	"Bugün"
"[english]vgui_Today"	"Today"
"vgui_Yesterday"	"Dün"
"[english]vgui_Yesterday"	"Yesterday"
"vgui_Tomorrow"	"Yarın"
"[english]vgui_Tomorrow"	"Tomorrow"
"vgui_OnForDays"	"%days% gün boyunca"
"[english]vgui_OnForDays"	"On for %days% days"
"vgui_OnForHours"	"%hours% saat boyunca"
"[english]vgui_OnForHours"	"On for %hours% hours"
"vgui_OnForMinutes"	"%minutes% dakika boyunca"
"[english]vgui_OnForMinutes"	"On for %minutes% minutes"
"vgui_OnForSeconds"	"%seconds% saniye boyunca"
"[english]vgui_OnForSeconds"	"On for %seconds% seconds"
"vgui_OnForDay"	"%days% gün boyunca"
"[english]vgui_OnForDay"	"On for %days% day"
"vgui_OnForHour"	"%hours% saat boyunca"
"[english]vgui_OnForHour"	"On for %hours% hour"
"vgui_OnForMinute"	"%minutes% dakika boyunca"
"[english]vgui_OnForMinute"	"On for %minutes% minute"
"vgui_OnForSecond"	"%seconds% saniye boyunca"
"[english]vgui_OnForSecond"	"On for %seconds% second"
"vgui_LastOnYearOrMore"	"Son Çevrimiçi: 1 yıldan daha fazla"
"[english]vgui_LastOnYearOrMore"	"Last Online: more than 1 year ago"
"vgui_LastOnDays"	"Son Çevrimiçi: %days% gün önce"
"[english]vgui_LastOnDays"	"Last Online: %days% days ago"
"vgui_LastOnHours"	"Son Çevrimiçi: %hours% saat önce"
"[english]vgui_LastOnHours"	"Last Online: %hours% hours ago"
"vgui_LastOnMinutes"	"Son Çevrimiçi: %minutes% dakika önce"
"[english]vgui_LastOnMinutes"	"Last Online: %minutes% minutes ago"
"vgui_LastOnSeconds"	"Son Çevrimiçi: %seconds% saniye önce"
"[english]vgui_LastOnSeconds"	"Last Online: %seconds% seconds ago"
"vgui_LastOnDay"	"Son Çevrimiçi: %days% gün önce"
"[english]vgui_LastOnDay"	"Last Online: %days% day ago"
"vgui_LastOnHour"	"Son Çevrimiçi: %hours% saat önce"
"[english]vgui_LastOnHour"	"Last Online: %hours% hour ago"
"vgui_LastOnMinute"	"Son Çevrimiçi: %minutes% dakika önce"
"[english]vgui_LastOnMinute"	"Last Online: %minutes% minute ago"
"vgui_LastOnSecond"	"Son Çevrimiçi: %seconds% saniye önce"
"[english]vgui_LastOnSecond"	"Last Online: %seconds% second ago"
"vgui_TimeAgoYearOrMore"	"1 yıldan fazla"
"[english]vgui_TimeAgoYearOrMore"	"more than 1 year ago"
"vgui_TimeAgoDays"	"%days% gün önce"
"[english]vgui_TimeAgoDays"	"%days% days ago"
"vgui_TimeAgoHours"	"%hours% saat önce"
"[english]vgui_TimeAgoHours"	"%hours% hours ago"
"vgui_TimeAgoMinutes"	"%minutes% dakika önce"
"[english]vgui_TimeAgoMinutes"	"%minutes% minutes ago"
"vgui_TimeAgoSeconds"	"%seconds% saniye önce"
"[english]vgui_TimeAgoSeconds"	"%seconds% seconds ago"
"vgui_TimeAgoDay"	"%days% gün önce"
"[english]vgui_TimeAgoDay"	"%days% day ago"
"vgui_TimeAgoHour"	"%hours% saat önce"
"[english]vgui_TimeAgoHour"	"%hours% hour ago"
"vgui_TimeAgoMinute"	"%minutes% dakika önce"
"[english]vgui_TimeAgoMinute"	"%minutes% minute ago"
"vgui_TimeAgoSecond"	"%seconds% saniye önce"
"[english]vgui_TimeAgoSecond"	"%seconds% second ago"
"FileOpenDialog_Col_Name"	"İsim"
"[english]FileOpenDialog_Col_Name"	"Name"
"FileOpenDialog_Col_Size"	"Boyut"
"[english]FileOpenDialog_Col_Size"	"Size"
"FileOpenDialog_Col_Type"	"Tür"
"[english]FileOpenDialog_Col_Type"	"Type"
"FileOpenDialog_Col_DateModified"	"Değiştirilme Tarihi"
"[english]FileOpenDialog_Col_DateModified"	"Date Modified"
"FileOpenDialog_Col_DateCreated"	"Oluşturulma Tarihi"
"[english]FileOpenDialog_Col_DateCreated"	"Date Created"
"FileOpenDialog_Col_Attributes"	"Özellikler"
"[english]FileOpenDialog_Col_Attributes"	"Attributes"
"FileOpenDialog_FileType_Folder"	"Dosya Klasörü"
"[english]FileOpenDialog_FileType_Folder"	"File Folder"
"FileOpenDialog_ToolTip_Up"	"Yukarı"
"[english]FileOpenDialog_ToolTip_Up"	"Up"
"FileOpenDialog_ToolTip_NewFolder"	"Yeni Klasör"
"[english]FileOpenDialog_ToolTip_NewFolder"	"New Folder"
"FileOpenDialog_NewFolder_InputTitle"	"Yeni Klasör"
"[english]FileOpenDialog_NewFolder_InputTitle"	"New Folder"
"FileOpenDialog_NewFolderPrompt"	"İsim:"
"[english]FileOpenDialog_NewFolderPrompt"	"Name:"
"FileOpenDialog_NewFolder_DefaultName"	"Yeni Klasör"
"[english]FileOpenDialog_NewFolder_DefaultName"	"New Folder"
"vgui_Webkit_error_title"	"Hata"
"[english]vgui_Webkit_error_title"	"Error"
"vgui_Webkit_pagetypeunsupported"	"Sayfa yüklenemiyor, desteklenmeyen sayfa biçimi"
"[english]vgui_Webkit_pagetypeunsupported"	"Unable to load page, unsupported page format"
"vgui_Webkit_cachemiss"	"İsteğinizin süresi doldu. 'Yenile'yi tıklayarak form verilerini tekrar isteyin."
"[english]vgui_Webkit_cachemiss"	"Your form request has expired. Click reload to re-submit the form data."
"vgui_Webkit_badurl"	"Bağlantı (URL) yüklenemiyor, yanlış alan adı veya biçimi"
"[english]vgui_Webkit_badurl"	"Unable to load URL, bad hostname or format"
"vgui_Webkit_connectionproblem"	"Sunucuya bağlanılamıyor, sunucu çevrimdışı veya internete bağlı değilsiniz."
"[english]vgui_Webkit_connectionproblem"	"Unable to connect to server. Server may be offline or you may not be connected to the internet."
"vgui_Webkit_unknown"	"Sayfa yüklenemedi (bilinmeyen hata)."
"[english]vgui_Webkit_unknown"	"Failed to load web page (unknown error)."
"vgui_HTMLBack"	"Geri"
"[english]vgui_HTMLBack"	"Back"
"vgui_HTMLForward"	"İleri"
"[english]vgui_HTMLForward"	"Forward"
"vgui_HTMLReload"	"Yenile"
"[english]vgui_HTMLReload"	"Reload"
"vgui_HTMLStop"	"Dur"
"[english]vgui_HTMLStop"	"Stop"
"vgui_HTMLViewSource"	"Kaynağı Görüntüle..."
"[english]vgui_HTMLViewSource"	"View Source..."
"vgui_Webkit_error_header"	"Hata Kodu: "
"[english]vgui_Webkit_error_header"	"Error Code: "
"vgui_Webkit_proxyconnectionproblem"	"HTTP Proxy ile bağlantı kurulamıyor. Proxy hatalı ya da çevrimdışı olabilir."
"[english]vgui_Webkit_proxyconnectionproblem"	"Unable to connect to HTTP Proxy. Your proxy may be misconfigured or offline."
"vgui_HTMLCopyUrl"	"Sayfa Bağlantısını Kopyala"
"[english]vgui_HTMLCopyUrl"	"Copy Page URL"
"vgui_HTMLCopyLink"	"Bağlantı Adresini Kopyala"
"[english]vgui_HTMLCopyLink"	"Copy Link Address"
"vgui_HTMLSearchMatch"	"%findactive% / %findcount%"
"[english]vgui_HTMLSearchMatch"	"%findactive% of %findcount%"
"vgui_HTMLSearchThisPage"	"Bu sayfada ara"
"[english]vgui_HTMLSearchThisPage"	"Search this page"
"vgui_choosedirectoryname"	"Dizin adı seçin"
"[english]vgui_choosedirectoryname"	"Choose directory name"
"TextEntry_CopyAllToClipboard"	"Tüm metni panoya kopyala"
"[english]TextEntry_CopyAllToClipboard"	"Copy all text to clipboard"
"vgui_yes"	"Evet"
"[english]vgui_yes"	"Yes"
"vgui_no"	"Hayır"
"[english]vgui_no"	"No"
"vgui_HTMLCloseDevTools"	"Geliştirici Araçlarını Kapat"
"[english]vgui_HTMLCloseDevTools"	"Close Developer Tools"
"vgui_HTMLOpenDevTools"	"Geliştirici Araçlarını Aç"
"[english]vgui_HTMLOpenDevTools"	"Open Developer Tools"
"vgui_continue"	"Devam"
"[english]vgui_continue"	"Continue"
"vgui_ShuttingDown"	"Kapatılıyor..."
"[english]vgui_ShuttingDown"	"Shutting down..."
"vgui_HTMLInspectElement"	"Öğeyi İncele"
"[english]vgui_HTMLInspectElement"	"Inspect Element"
}
}
