"lang"
{
"Language"	"ukrainian"
"Tokens"
{
"TextEntry_Cut"	"Вирізати"
"[english]TextEntry_Cut"	"Cut"
"TextEntry_Copy"	"Копіювати"
"[english]TextEntry_Copy"	"Copy"
"TextEntry_Paste"	"Вставити"
"[english]TextEntry_Paste"	"Paste"
"TextEntry_SelectAll"	"Виділити все"
"[english]TextEntry_SelectAll"	"Select all"
"FileOpenDialog_Open"	"Відкрити"
"[english]FileOpenDialog_Open"	"Open"
"FileOpenDialog_Cancel"	"Скасувати"
"[english]FileOpenDialog_Cancel"	"Cancel"
"FileOpenDialog_Look_in"	"Шукати в:"
"[english]FileOpenDialog_Look_in"	"Look in:"
"FileOpenDialog_File_Name"	"Назва файлу:"
"[english]FileOpenDialog_File_Name"	"File name:"
"FileOpenDialog_File_Type"	"Тип файлу:"
"[english]FileOpenDialog_File_Type"	"File type:"
"FileOpenDialog_Icon"	" "
"[english]FileOpenDialog_Icon"	" "
"FileOpenDialog_Name"	"Назва"
"[english]FileOpenDialog_Name"	"Name"
"FileOpenDialog_Type"	"Тип"
"[english]FileOpenDialog_Type"	"Type"
"SysMenu_Minimize"	" Згорнути "
"[english]SysMenu_Minimize"	" Minimize "
"SysMenu_Maximize"	" Розгорнути "
"[english]SysMenu_Maximize"	" Maximize "
"SysMenu_Close"	" Закрити "
"[english]SysMenu_Close"	" Close "
"Frame_Untitled"	"Без назви"
"[english]Frame_Untitled"	"Untitled"
"MessageBox_OK"	"Гаразд"
"[english]MessageBox_OK"	"OK"
"PropertyDialog_OK"	"Гаразд"
"[english]PropertyDialog_OK"	"OK"
"PropertyDialog_Cancel"	"Скасувати"
"[english]PropertyDialog_Cancel"	"Cancel"
"PropertyDialog_Apply"	"Застосувати"
"[english]PropertyDialog_Apply"	"Apply"
"QueryBox_Cancel"	"Скасувати"
"[english]QueryBox_Cancel"	"Cancel"
"WizardPanel_Next"	"Далі >"
"[english]WizardPanel_Next"	"Next >"
"WizardPanel_Back"	"< Назад"
"[english]WizardPanel_Back"	"< Back"
"WizardPanel_Finish"	"Готово"
"[english]WizardPanel_Finish"	"Finish"
"WizardPanel_Cancel"	"Скасувати"
"[english]WizardPanel_Cancel"	"Cancel"
"vgui_ok"	"Гаразд"
"[english]vgui_ok"	"OK"
"vgui_close"	"Закрити"
"[english]vgui_close"	"Close"
"vgui_Cancel"	"Скасувати"
"[english]vgui_Cancel"	"Cancel"
"vgui_select"	"Обрати"
"[english]vgui_select"	"Select"
"vgui_createfolder"	"Створити папку…"
"[english]vgui_createfolder"	"New Folder..."
"vgui_next"	"Далі >"
"[english]vgui_next"	"Next >"
"vgui_back"	"< Назад"
"[english]vgui_back"	"< Back"
"vgui_CreateDirectoryFail_Title"	"Створення теки — Помилка"
"[english]vgui_CreateDirectoryFail_Title"	"Create Folder - Error"
"vgui_CreateDirectoryFail_Info"	"Не вдалося створити папку, цей диск доступний тільки для читання."
"[english]vgui_CreateDirectoryFail_Info"	"Failed to create a folder, this drive is read-only."
"vgui_CreateDirectoryFail_AlreadyExists"	"Ця тека вже існує."
"[english]vgui_CreateDirectoryFail_AlreadyExists"	"That folder already exists."
"TextEntry_Language"	"Мова"
"[english]TextEntry_Language"	"Language"
"TextEntry_ConversionMode"	"Режим перетворення"
"[english]TextEntry_ConversionMode"	"Conversion Mode"
"TextEntry_SentenceMode"	"Режим речення"
"[english]TextEntry_SentenceMode"	"Sentence Mode"
"IME_English"	"Англійська"
"[english]IME_English"	"English"
"IME_Chinese"	"Китайська"
"[english]IME_Chinese"	"Chinese"
"IME_Korean"	"Корейська"
"[english]IME_Korean"	"Korean"
"IME_Hiragana"	"Хіраґана"
"[english]IME_Hiragana"	"Hiragana"
"IME_FullWidthKatakana"	"Катакана (повноширинний шрифт)"
"[english]IME_FullWidthKatakana"	"Full-width Katakana"
"IME_FullWidthAlphanumeric"	"Літери та цифри (повноширинний шрифт)"
"[english]IME_FullWidthAlphanumeric"	"Full-width Alphanumeric"
"IME_HalfWidthKatakana"	"Катакана (напівширинний шрифт)"
"[english]IME_HalfWidthKatakana"	"Half-width Katakana"
"IME_HalfWidthAlphanumeric"	"Літери та цифри (напівширинний шрифт)"
"[english]IME_HalfWidthAlphanumeric"	"Half-width Alphanumeric"
"IME_General"	"Загальна таблиця"
"[english]IME_General"	"General"
"IME_BiasNames"	"Схільність до назв"
"[english]IME_BiasNames"	"Bias for Names"
"IME_BiasSpeech"	"Схильність до вимови"
"[english]IME_BiasSpeech"	"Bias for Speech"
"IME_NoConversion"	"Не перетворювати"
"[english]IME_NoConversion"	"No Conversion"
"IME_0404"	"Китайська (Тайвань)"
"[english]IME_0404"	"Chinese (Taiwan)"
"IME_0804"	"Китайська (КНР)"
"[english]IME_0804"	"Chinese (PRC)"
"IME_0409"	"Англійська (США)"
"[english]IME_0409"	"English (United States)"
"IME_0411"	"Японська"
"[english]IME_0411"	"Japanese"
"IME_0412"	"Корейська"
"[english]IME_0412"	"Korean"
"IME_0419"	"Російська"
"[english]IME_0419"	"Russian"
"IME_041e"	"Тайська"
"[english]IME_041e"	"Thai"
"IME_040c"	"Французька (стандартна)"
"[english]IME_040c"	"French (Standard)"
"IME_0407"	"Німецька (стандартна)"
"[english]IME_0407"	"German (Standard)"
"IME_0410"	"Італійська (стандартна)"
"[english]IME_0410"	"Italian (Standard)"
"IME_040a"	"Іспанська (Іспанія, традиційне сортування)"
"[english]IME_040a"	"Spanish (Spain, Traditional Sort)"
"vgui_FileCopyDialog_Title"	"Копіювання…"
"[english]vgui_FileCopyDialog_Title"	"Copying..."
"vgui_FileMoveDialog_Title"	"Переміщення…"
"[english]vgui_FileMoveDialog_Title"	"Moving..."
"vgui_FileCopy_Estimate"	"Залишилося %s1"
"[english]vgui_FileCopy_Estimate"	"%s1 remaining"
"vgui_FileCopy_Copying_Multiple"	"Копіюється «%s1» (залишилося %s2)"
"[english]vgui_FileCopy_Copying_Multiple"	"Copying '%s1' (%s2 remaining)"
"vgui_FileCopy_Copying_Single"	"Копіюється «%s1»"
"[english]vgui_FileCopy_Copying_Single"	"Copying '%s1'"
"vgui_FileCopy_Ovewwrite_Title"	"Заміна файлів"
"[english]vgui_FileCopy_Ovewwrite_Title"	"Overwrite file(s)"
"vgui_FileCopy_Ovewwrite_Prompt"	"Перезаписати «%filename%»?"
"[english]vgui_FileCopy_Ovewwrite_Prompt"	"Overwrite '%filename%'?"
"SMPEvent_AppLaunch"	"Запуск застосунку"
"[english]SMPEvent_AppLaunch"	"App Launch"
"SMPEvent_AppExit"	"Завершення застосунку"
"[english]SMPEvent_AppExit"	"App Exit"
"SMPEvent_Close"	"Закрити"
"[english]SMPEvent_Close"	"Close"
"SMPEvent_FadeOut"	"Зникання"
"[english]SMPEvent_FadeOut"	"Fade Out"
"SMPEvent_MediaBegin"	"Початок відтворення"
"[english]SMPEvent_MediaBegin"	"Media Begin"
"SMPEvent_MediaEnd"	"Кінець відтворення"
"[english]SMPEvent_MediaEnd"	"Media End"
"SMPEvent_Play"	"Відтворити"
"[english]SMPEvent_Play"	"Play"
"SMPEvent_JumpHome"	"До початку"
"[english]SMPEvent_JumpHome"	"Jump Home"
"SMPEvent_JumpEnd"	"У кінець"
"[english]SMPEvent_JumpEnd"	"Jump To End"
"SMPEvent_Pause"	"Пауза"
"[english]SMPEvent_Pause"	"Pause"
"SMPEvent_Stop"	"Зупинити"
"[english]SMPEvent_Stop"	"Stop"
"SMPEvent_JumpFrom"	"Відтворити з"
"[english]SMPEvent_JumpFrom"	"Scrub From"
"SMPEvent_JumpTo"	"Відтворити до"
"[english]SMPEvent_JumpTo"	"Scrub To"
"SMPEvent_StepFwd"	"Крок уперед"
"[english]SMPEvent_StepFwd"	"Step Forward"
"SMPEvent_StepBack"	"Крок назад"
"[english]SMPEvent_StepBack"	"Step Backwards"
"SMPEvent_JumpFwd"	"Трохи вперед"
"[english]SMPEvent_JumpFwd"	"Jump Forward"
"SMPEvent_JumpBack"	"Трохи назад"
"[english]SMPEvent_JumpBack"	"Jump Backwards"
"SMPEvent_Repeat"	"Повторити"
"[english]SMPEvent_Repeat"	"Repeat"
"SMPEvent_Maximize"	"Розгорнути"
"[english]SMPEvent_Maximize"	"Maximize"
"SMPEvent_Minimize"	"Згорнути"
"[english]SMPEvent_Minimize"	"Minimize"
"SMPEvent_Restore"	"Відновити"
"[english]SMPEvent_Restore"	"Restore"
"SMPStats_UserId"	"ID користувача:"
"[english]SMPStats_UserId"	"User Id:"
"SMPStats_Filename"	"Назва файлу:"
"[english]SMPStats_Filename"	"Filename:"
"SMPStats_EventTitle"	"Подія"
"[english]SMPStats_EventTitle"	"Event"
"SMPStats_TimeTitle"	"Час (мс)"
"[english]SMPStats_TimeTitle"	"Time (ms)"
"SMPStats_PositionTitle"	"Позиція (мс)"
"[english]SMPStats_PositionTitle"	"Position (ms)"
"SMPStats_DialogTitle"	"Налаштування збору даних"
"[english]SMPStats_DialogTitle"	"Data Collection Preferences"
"SMPStats_DontAskAgain"	"Більше не питати"
"[english]SMPStats_DontAskAgain"	"Don't ask again"
"vgui_Accept"	"Прийняти"
"[english]vgui_Accept"	"Accept"
"vgui_Decline"	"Відхилити"
"[english]vgui_Decline"	"Decline"
"vgui_TimeLeftYearOrMore"	"більше року"
"[english]vgui_TimeLeftYearOrMore"	"more than 1 year"
"vgui_TimeLeftDay"	"%days% день"
"[english]vgui_TimeLeftDay"	"%days% day"
"vgui_TimeLeftDays"	"%days% дн."
"[english]vgui_TimeLeftDays"	"%days% days"
"vgui_TimeLeftDayRemaining"	"Залишилося %days% дн."
"[english]vgui_TimeLeftDayRemaining"	"%days% day remaining"
"vgui_TimeLeftDaysRemaining"	"Залишилося %days% дн."
"[english]vgui_TimeLeftDaysRemaining"	"%days% days remaining"
"vgui_TimeLeftHour"	"%hours% год."
"[english]vgui_TimeLeftHour"	"%hours% hour"
"vgui_TimeLeftHours"	"%hours% год."
"[english]vgui_TimeLeftHours"	"%hours% hours"
"vgui_TimeLeftHourRemaining"	"Залишилося %hours% год."
"[english]vgui_TimeLeftHourRemaining"	"%hours% hour remaining"
"vgui_TimeLeftHoursRemaining"	"Залишилося %hours% год."
"[english]vgui_TimeLeftHoursRemaining"	"%hours% hours remaining"
"vgui_TimeLeftMinute"	"%minutes% хв."
"[english]vgui_TimeLeftMinute"	"%minutes% minute"
"vgui_TimeLeftMinutes"	"%minutes% хв."
"[english]vgui_TimeLeftMinutes"	"%minutes% minutes"
"vgui_TimeLeftMinuteRemaining"	"Залишилося %minutes% хв."
"[english]vgui_TimeLeftMinuteRemaining"	"%minutes% minute remaining"
"vgui_TimeLeftMinutesRemaining"	"Залишилося %minutes% хв."
"[english]vgui_TimeLeftMinutesRemaining"	"%minutes% minutes remaining"
"vgui_TimeLeftSecond"	"%seconds% с"
"[english]vgui_TimeLeftSecond"	"%seconds% second"
"vgui_TimeLeftSeconds"	"%seconds% с"
"[english]vgui_TimeLeftSeconds"	"%seconds% seconds"
"vgui_TimeLeftSecondRemaining"	"Залишилося %seconds% с"
"[english]vgui_TimeLeftSecondRemaining"	"%seconds% second remaining"
"vgui_TimeLeftSecondsRemaining"	"Залишилося %seconds% с"
"[english]vgui_TimeLeftSecondsRemaining"	"%seconds% seconds remaining"
"vgui_TimeLeftDaysHours"	"%days% дн. %hours% год."
"[english]vgui_TimeLeftDaysHours"	"%days% days %hours% hours"
"vgui_TimeLeftDaysHour"	"%days% дн. %hours% год."
"[english]vgui_TimeLeftDaysHour"	"%days% days %hours% hour"
"vgui_TimeLeftDayHours"	"%days% день %hours% год."
"[english]vgui_TimeLeftDayHours"	"%days% day %hours% hours"
"vgui_TimeLeftDayHour"	"%days% день %hours% год."
"[english]vgui_TimeLeftDayHour"	"%days% day %hours% hour"
"vgui_TimeLeftDaysHoursRemaining"	"Залишилося %days% дн. %hours% год."
"[english]vgui_TimeLeftDaysHoursRemaining"	"%days% days %hours% hours remaining"
"vgui_TimeLeftDaysHourRemaining"	"Залишилося %days% дн. %hours% год."
"[english]vgui_TimeLeftDaysHourRemaining"	"%days% days %hours% hour remaining"
"vgui_TimeLeftDayHoursRemaining"	"Залишилося %days% дн. %hours% год."
"[english]vgui_TimeLeftDayHoursRemaining"	"%days% day %hours% hours remaining"
"vgui_TimeLeftDayHourRemaining"	"Залишилося %days% дн. %hours% год."
"[english]vgui_TimeLeftDayHourRemaining"	"%days% day %hours% hour remaining"
"vgui_TimeLeftHoursMinutes"	"%hours% год. %minutes% хв."
"[english]vgui_TimeLeftHoursMinutes"	"%hours% hours %minutes% minutes"
"vgui_TimeLeftHoursMinute"	"%hours% год. %minutes% хв."
"[english]vgui_TimeLeftHoursMinute"	"%hours% hours %minutes% minute"
"vgui_TimeLeftHourMinutes"	"%hours% год. %minutes% хв."
"[english]vgui_TimeLeftHourMinutes"	"%hours% hour %minutes% minutes"
"vgui_TimeLeftHourMinute"	"%hours% год. %minutes% хв."
"[english]vgui_TimeLeftHourMinute"	"%hours% hour %minutes% minute"
"vgui_TimeLeftHoursMinutesRemaining"	"Залишилося %hours% год. %minutes% хв."
"[english]vgui_TimeLeftHoursMinutesRemaining"	"%hours% hours %minutes% minutes remaining"
"vgui_TimeLeftHoursMinuteRemaining"	"Залишилося %hours% год. %minutes% хв."
"[english]vgui_TimeLeftHoursMinuteRemaining"	"%hours% hours %minutes% minute remaining"
"vgui_TimeLeftHourMinutesRemaining"	"Залишилося %hours% год. %minutes% хв."
"[english]vgui_TimeLeftHourMinutesRemaining"	"%hours% hour %minutes% minutes remaining"
"vgui_TimeLeftHourMinuteRemaining"	"Залишилося %hours% год. %minutes% хв."
"[english]vgui_TimeLeftHourMinuteRemaining"	"%hours% hour %minutes% minute remaining"
"vgui_TimeLeftMinutesSeconds"	"%minutes% хв. %seconds% с"
"[english]vgui_TimeLeftMinutesSeconds"	"%minutes% minutes %seconds% seconds"
"vgui_TimeLeftMinutesSecond"	"%minutes% хв. %seconds% с"
"[english]vgui_TimeLeftMinutesSecond"	"%minutes% minutes %seconds% second"
"vgui_TimeLeftMinuteSeconds"	"%minutes% хв. %seconds% с"
"[english]vgui_TimeLeftMinuteSeconds"	"%minutes% minute %seconds% seconds"
"vgui_TimeLeftMinuteSecond"	"%minutes% хв. %seconds% с"
"[english]vgui_TimeLeftMinuteSecond"	"%minutes% minute %seconds% second"
"vgui_TimeLeftMinutesSecondsRemaining"	"Залишилося %minutes% хв. %seconds% с"
"[english]vgui_TimeLeftMinutesSecondsRemaining"	"%minutes% minutes %seconds% seconds remaining"
"vgui_TimeLeftMinutesSecondRemaining"	"Залишилося %minutes% хв. %seconds% с"
"[english]vgui_TimeLeftMinutesSecondRemaining"	"%minutes% minutes %seconds% second remaining"
"vgui_TimeLeftMinuteSecondsRemaining"	"Залишилося %minutes% хв. %seconds% с"
"[english]vgui_TimeLeftMinuteSecondsRemaining"	"%minutes% minute %seconds% seconds remaining"
"vgui_TimeLeftMinuteSecondRemaining"	"Залишилося %minutes% хв. %seconds% с"
"[english]vgui_TimeLeftMinuteSecondRemaining"	"%minutes% minute %seconds% second remaining"
"vgui_Today"	"Сьогодні"
"[english]vgui_Today"	"Today"
"vgui_Yesterday"	"Учора"
"[english]vgui_Yesterday"	"Yesterday"
"vgui_Tomorrow"	"Завтра"
"[english]vgui_Tomorrow"	"Tomorrow"
"vgui_OnForDays"	"У мережі вже %days% дн."
"[english]vgui_OnForDays"	"On for %days% days"
"vgui_OnForHours"	"У мережі вже %hours% год."
"[english]vgui_OnForHours"	"On for %hours% hours"
"vgui_OnForMinutes"	"У мережі вже %minutes% хв."
"[english]vgui_OnForMinutes"	"On for %minutes% minutes"
"vgui_OnForSeconds"	"У мережі вже %seconds% с"
"[english]vgui_OnForSeconds"	"On for %seconds% seconds"
"vgui_OnForDay"	"У мережі вже %days% день"
"[english]vgui_OnForDay"	"On for %days% day"
"vgui_OnForHour"	"У мережі вже %hours% год."
"[english]vgui_OnForHour"	"On for %hours% hour"
"vgui_OnForMinute"	"У мережі вже %minutes% хв."
"[english]vgui_OnForMinute"	"On for %minutes% minute"
"vgui_OnForSecond"	"У мережі вже %seconds% с"
"[english]vgui_OnForSecond"	"On for %seconds% second"
"vgui_LastOnYearOrMore"	"Востаннє в мережі: більше року тому"
"[english]vgui_LastOnYearOrMore"	"Last Online: more than 1 year ago"
"vgui_LastOnDays"	"Востаннє в мережі: %days% дн. тому"
"[english]vgui_LastOnDays"	"Last Online: %days% days ago"
"vgui_LastOnHours"	"Востаннє в мережі: %hours% год. тому"
"[english]vgui_LastOnHours"	"Last Online: %hours% hours ago"
"vgui_LastOnMinutes"	"Востаннє в мережі: %minutes% хв. тому"
"[english]vgui_LastOnMinutes"	"Last Online: %minutes% minutes ago"
"vgui_LastOnSeconds"	"Востаннє в мережі: %seconds% с тому"
"[english]vgui_LastOnSeconds"	"Last Online: %seconds% seconds ago"
"vgui_LastOnDay"	"Востаннє в мережі: %days% день тому"
"[english]vgui_LastOnDay"	"Last Online: %days% day ago"
"vgui_LastOnHour"	"Востаннє в мережі: %hours% год. тому"
"[english]vgui_LastOnHour"	"Last Online: %hours% hour ago"
"vgui_LastOnMinute"	"Востаннє в мережі: %minutes% хв. тому"
"[english]vgui_LastOnMinute"	"Last Online: %minutes% minute ago"
"vgui_LastOnSecond"	"Востаннє в мережі: %seconds% с тому"
"[english]vgui_LastOnSecond"	"Last Online: %seconds% second ago"
"vgui_TimeAgoYearOrMore"	"більше року тому"
"[english]vgui_TimeAgoYearOrMore"	"more than 1 year ago"
"vgui_TimeAgoDays"	"%days% дн. тому"
"[english]vgui_TimeAgoDays"	"%days% days ago"
"vgui_TimeAgoHours"	"%hours% год. тому"
"[english]vgui_TimeAgoHours"	"%hours% hours ago"
"vgui_TimeAgoMinutes"	"%minutes% хв. тому"
"[english]vgui_TimeAgoMinutes"	"%minutes% minutes ago"
"vgui_TimeAgoSeconds"	"%seconds% с тому"
"[english]vgui_TimeAgoSeconds"	"%seconds% seconds ago"
"vgui_TimeAgoDay"	"%days% день тому"
"[english]vgui_TimeAgoDay"	"%days% day ago"
"vgui_TimeAgoHour"	"%hours% год. тому"
"[english]vgui_TimeAgoHour"	"%hours% hour ago"
"vgui_TimeAgoMinute"	"%minutes% хв. тому"
"[english]vgui_TimeAgoMinute"	"%minutes% minute ago"
"vgui_TimeAgoSecond"	"%seconds% с тому"
"[english]vgui_TimeAgoSecond"	"%seconds% second ago"
"FileOpenDialog_Col_Name"	"Назва"
"[english]FileOpenDialog_Col_Name"	"Name"
"FileOpenDialog_Col_Size"	"Розмір"
"[english]FileOpenDialog_Col_Size"	"Size"
"FileOpenDialog_Col_Type"	"Тип"
"[english]FileOpenDialog_Col_Type"	"Type"
"FileOpenDialog_Col_DateModified"	"Дата зміни"
"[english]FileOpenDialog_Col_DateModified"	"Date Modified"
"FileOpenDialog_Col_DateCreated"	"Дата створення"
"[english]FileOpenDialog_Col_DateCreated"	"Date Created"
"FileOpenDialog_Col_Attributes"	"Атрибути"
"[english]FileOpenDialog_Col_Attributes"	"Attributes"
"FileOpenDialog_FileType_Folder"	"Тека"
"[english]FileOpenDialog_FileType_Folder"	"File Folder"
"FileOpenDialog_ToolTip_Up"	"Догори"
"[english]FileOpenDialog_ToolTip_Up"	"Up"
"FileOpenDialog_ToolTip_NewFolder"	"Нова тека"
"[english]FileOpenDialog_ToolTip_NewFolder"	"New Folder"
"FileOpenDialog_NewFolder_InputTitle"	"Нова тека"
"[english]FileOpenDialog_NewFolder_InputTitle"	"New Folder"
"FileOpenDialog_NewFolderPrompt"	"Назва:"
"[english]FileOpenDialog_NewFolderPrompt"	"Name:"
"FileOpenDialog_NewFolder_DefaultName"	"Нова тека"
"[english]FileOpenDialog_NewFolder_DefaultName"	"New Folder"
"vgui_Webkit_error_title"	"Помилка"
"[english]vgui_Webkit_error_title"	"Error"
"vgui_Webkit_pagetypeunsupported"	"Не вдалося завантажити сторінку — непідтримуваний формат"
"[english]vgui_Webkit_pagetypeunsupported"	"Unable to load page, unsupported page format"
"vgui_Webkit_cachemiss"	"Сплинув термін вашого запиту до форми. Клацніть «Оновити», аби надіслати дані повторно."
"[english]vgui_Webkit_cachemiss"	"Your form request has expired. Click reload to re-submit the form data."
"vgui_Webkit_badurl"	"Помилка завантаження посилання, неприпустима адреса або формат"
"[english]vgui_Webkit_badurl"	"Unable to load URL, bad hostname or format"
"vgui_Webkit_connectionproblem"	"Не вдалося з’єднатися із сервером. Або сервер відключено або ви не під’єднані до Інтернету."
"[english]vgui_Webkit_connectionproblem"	"Unable to connect to server. Server may be offline or you may not be connected to the internet."
"vgui_Webkit_unknown"	"Не вдалося завантажити веб-сторінку (невідома помилка)."
"[english]vgui_Webkit_unknown"	"Failed to load web page (unknown error)."
"vgui_HTMLBack"	"Назад"
"[english]vgui_HTMLBack"	"Back"
"vgui_HTMLForward"	"Уперед"
"[english]vgui_HTMLForward"	"Forward"
"vgui_HTMLReload"	"Оновити"
"[english]vgui_HTMLReload"	"Reload"
"vgui_HTMLStop"	"Зупинити"
"[english]vgui_HTMLStop"	"Stop"
"vgui_HTMLViewSource"	"Переглянути вихідний код…"
"[english]vgui_HTMLViewSource"	"View Source..."
"vgui_Webkit_error_header"	"Код помилки: "
"[english]vgui_Webkit_error_header"	"Error Code: "
"vgui_Webkit_proxyconnectionproblem"	"Не вдалося з’єднатися з проксі-сервером HTTP. Ваш проксі-сервер можливо неправильно налаштований або відключений."
"[english]vgui_Webkit_proxyconnectionproblem"	"Unable to connect to HTTP Proxy. Your proxy may be misconfigured or offline."
"vgui_HTMLCopyUrl"	"Копіювати посилання на сторінку"
"[english]vgui_HTMLCopyUrl"	"Copy Page URL"
"vgui_HTMLCopyLink"	"Копіювати адресу посилання"
"[english]vgui_HTMLCopyLink"	"Copy Link Address"
"vgui_HTMLSearchMatch"	"%findactive% з %findcount%"
"[english]vgui_HTMLSearchMatch"	"%findactive% of %findcount%"
"vgui_HTMLSearchThisPage"	"Шукати на цій сторінці"
"[english]vgui_HTMLSearchThisPage"	"Search this page"
"vgui_choosedirectoryname"	"Оберіть назву теки"
"[english]vgui_choosedirectoryname"	"Choose directory name"
"TextEntry_CopyAllToClipboard"	"Копіювати весь текст до буфера обміну"
"[english]TextEntry_CopyAllToClipboard"	"Copy all text to clipboard"
"vgui_yes"	"Так"
"[english]vgui_yes"	"Yes"
"vgui_no"	"Ні"
"[english]vgui_no"	"No"
"vgui_HTMLCloseDevTools"	"Закрити засоби розробника"
"[english]vgui_HTMLCloseDevTools"	"Close Developer Tools"
"vgui_HTMLOpenDevTools"	"Відкрити засоби розробника"
"[english]vgui_HTMLOpenDevTools"	"Open Developer Tools"
"vgui_continue"	"Продовжити"
"[english]vgui_continue"	"Continue"
"vgui_ShuttingDown"	"Вимкнення…"
"[english]vgui_ShuttingDown"	"Shutting down..."
"vgui_HTMLInspectElement"	"Оглянути елемент"
"[english]vgui_HTMLInspectElement"	"Inspect Element"
}
}
