"lang"
{
"Language"	"romanian"
"Tokens"
{
"TextEntry_Cut"	"Taie"
"[english]TextEntry_Cut"	"Cut"
"TextEntry_Copy"	"Copiază"
"[english]TextEntry_Copy"	"Copy"
"TextEntry_Paste"	"Inserează"
"[english]TextEntry_Paste"	"Paste"
"TextEntry_SelectAll"	"Selectează tot"
"[english]TextEntry_SelectAll"	"Select all"
"FileOpenDialog_Open"	"Deschide"
"[english]FileOpenDialog_Open"	"Open"
"FileOpenDialog_Cancel"	"Anulează"
"[english]FileOpenDialog_Cancel"	"Cancel"
"FileOpenDialog_Look_in"	"Caută în:"
"[english]FileOpenDialog_Look_in"	"Look in:"
"FileOpenDialog_File_Name"	"Nume fişier:"
"[english]FileOpenDialog_File_Name"	"File name:"
"FileOpenDialog_File_Type"	"Tip fişier:"
"[english]FileOpenDialog_File_Type"	"File type:"
"FileOpenDialog_Icon"	" "
"[english]FileOpenDialog_Icon"	" "
"FileOpenDialog_Name"	"Nume"
"[english]FileOpenDialog_Name"	"Name"
"FileOpenDialog_Type"	"Tip"
"[english]FileOpenDialog_Type"	"Type"
"SysMenu_Minimize"	"Ascunde"
"[english]SysMenu_Minimize"	" Minimize "
"SysMenu_Maximize"	" Maximizează "
"[english]SysMenu_Maximize"	" Maximize "
"SysMenu_Close"	" Închide "
"[english]SysMenu_Close"	" Close "
"Frame_Untitled"	"Fără titlu"
"[english]Frame_Untitled"	"Untitled"
"MessageBox_OK"	"OK"
"[english]MessageBox_OK"	"OK"
"PropertyDialog_OK"	"OK"
"[english]PropertyDialog_OK"	"OK"
"PropertyDialog_Cancel"	"Anulează"
"[english]PropertyDialog_Cancel"	"Cancel"
"PropertyDialog_Apply"	"Aplică"
"[english]PropertyDialog_Apply"	"Apply"
"QueryBox_Cancel"	"Anulează"
"[english]QueryBox_Cancel"	"Cancel"
"WizardPanel_Next"	"Înainte >"
"[english]WizardPanel_Next"	"Next >"
"WizardPanel_Back"	"< Înapoi"
"[english]WizardPanel_Back"	"< Back"
"WizardPanel_Finish"	"Încheiere"
"[english]WizardPanel_Finish"	"Finish"
"WizardPanel_Cancel"	"Anulează"
"[english]WizardPanel_Cancel"	"Cancel"
"vgui_ok"	"OK"
"[english]vgui_ok"	"OK"
"vgui_close"	"Închide"
"[english]vgui_close"	"Close"
"vgui_Cancel"	"Anulează"
"[english]vgui_Cancel"	"Cancel"
"vgui_select"	"Alege"
"[english]vgui_select"	"Select"
"vgui_createfolder"	"Folder Nou..."
"[english]vgui_createfolder"	"New Folder..."
"vgui_next"	"Continuă >"
"[english]vgui_next"	"Next >"
"vgui_back"	"< Înapoi"
"[english]vgui_back"	"< Back"
"vgui_CreateDirectoryFail_Title"	"Director nou - Eroare"
"[english]vgui_CreateDirectoryFail_Title"	"Create Folder - Error"
"vgui_CreateDirectoryFail_Info"	"Directorul nu poate fi creat, unitatea de disc este read-only."
"[english]vgui_CreateDirectoryFail_Info"	"Failed to create a folder, this drive is read-only."
"vgui_CreateDirectoryFail_AlreadyExists"	"Există deja acest director."
"[english]vgui_CreateDirectoryFail_AlreadyExists"	"That folder already exists."
"TextEntry_Language"	"Limbă"
"[english]TextEntry_Language"	"Language"
"TextEntry_ConversionMode"	"Mod de conversie"
"[english]TextEntry_ConversionMode"	"Conversion Mode"
"TextEntry_SentenceMode"	"Tip propoziţie"
"[english]TextEntry_SentenceMode"	"Sentence Mode"
"IME_English"	"Engleză"
"[english]IME_English"	"English"
"IME_Chinese"	"Chineză"
"[english]IME_Chinese"	"Chinese"
"IME_Korean"	"Coreeană"
"[english]IME_Korean"	"Korean"
"IME_Hiragana"	"Hiragana"
"[english]IME_Hiragana"	"Hiragana"
"IME_FullWidthKatakana"	"Full-width Katakana"
"[english]IME_FullWidthKatakana"	"Full-width Katakana"
"IME_FullWidthAlphanumeric"	"Full-width Alphanumeric"
"[english]IME_FullWidthAlphanumeric"	"Full-width Alphanumeric"
"IME_HalfWidthKatakana"	"Half-width Katakana"
"[english]IME_HalfWidthKatakana"	"Half-width Katakana"
"IME_HalfWidthAlphanumeric"	"Half-width Alphanumeric"
"[english]IME_HalfWidthAlphanumeric"	"Half-width Alphanumeric"
"IME_General"	"General"
"[english]IME_General"	"General"
"IME_BiasNames"	"Preferinţă pentru nume"
"[english]IME_BiasNames"	"Bias for Names"
"IME_BiasSpeech"	"Preferinţă pentru dialog"
"[english]IME_BiasSpeech"	"Bias for Speech"
"IME_NoConversion"	"Fără conversie"
"[english]IME_NoConversion"	"No Conversion"
"IME_0404"	"Chineză (Taiwan)"
"[english]IME_0404"	"Chinese (Taiwan)"
"IME_0804"	"Chineză (PRC)"
"[english]IME_0804"	"Chinese (PRC)"
"IME_0409"	"Engleză (Statele Unite)"
"[english]IME_0409"	"English (United States)"
"IME_0411"	"Japoneză"
"[english]IME_0411"	"Japanese"
"IME_0412"	"Coreeană"
"[english]IME_0412"	"Korean"
"IME_0419"	"Rusă"
"[english]IME_0419"	"Russian"
"IME_041e"	"Thailandeză"
"[english]IME_041e"	"Thai"
"IME_040c"	"Franceză (Standard)"
"[english]IME_040c"	"French (Standard)"
"IME_0407"	"Germană (Standard)"
"[english]IME_0407"	"German (Standard)"
"IME_0410"	"Italiană (Standard)"
"[english]IME_0410"	"Italian (Standard)"
"IME_040a"	"Spaniolă (Spania, dialect tradiţional)"
"[english]IME_040a"	"Spanish (Spain, Traditional Sort)"
"vgui_FileCopyDialog_Title"	"Se copiază..."
"[english]vgui_FileCopyDialog_Title"	"Copying..."
"vgui_FileMoveDialog_Title"	"Se mută..."
"[english]vgui_FileMoveDialog_Title"	"Moving..."
"vgui_FileCopy_Estimate"	"%s1 rămas"
"[english]vgui_FileCopy_Estimate"	"%s1 remaining"
"vgui_FileCopy_Copying_Multiple"	"Se copiază „%s1” (%s2 rămas)"
"[english]vgui_FileCopy_Copying_Multiple"	"Copying '%s1' (%s2 remaining)"
"vgui_FileCopy_Copying_Single"	"Se copiază „%s1”"
"[english]vgui_FileCopy_Copying_Single"	"Copying '%s1'"
"vgui_FileCopy_Ovewwrite_Title"	"Rescrie fişier(e)"
"[english]vgui_FileCopy_Ovewwrite_Title"	"Overwrite file(s)"
"vgui_FileCopy_Ovewwrite_Prompt"	"Rescrie „%filename%”?"
"[english]vgui_FileCopy_Ovewwrite_Prompt"	"Overwrite '%filename%'?"
"SMPEvent_AppLaunch"	"Porneşte aplicaţia"
"[english]SMPEvent_AppLaunch"	"App Launch"
"SMPEvent_AppExit"	"Părăseşte aplicaţia"
"[english]SMPEvent_AppExit"	"App Exit"
"SMPEvent_Close"	"Închide"
"[english]SMPEvent_Close"	"Close"
"SMPEvent_FadeOut"	"Atenuează"
"[english]SMPEvent_FadeOut"	"Fade Out"
"SMPEvent_MediaBegin"	"Început media"
"[english]SMPEvent_MediaBegin"	"Media Begin"
"SMPEvent_MediaEnd"	"Final media"
"[english]SMPEvent_MediaEnd"	"Media End"
"SMPEvent_Play"	"Redare"
"[english]SMPEvent_Play"	"Play"
"SMPEvent_JumpHome"	"Direct la prima pagină"
"[english]SMPEvent_JumpHome"	"Jump Home"
"SMPEvent_JumpEnd"	"Direct la sfârşit"
"[english]SMPEvent_JumpEnd"	"Jump To End"
"SMPEvent_Pause"	"Pauză"
"[english]SMPEvent_Pause"	"Pause"
"SMPEvent_Stop"	"Stop"
"[english]SMPEvent_Stop"	"Stop"
"SMPEvent_JumpFrom"	"Derulează de la"
"[english]SMPEvent_JumpFrom"	"Scrub From"
"SMPEvent_JumpTo"	"Derulează la"
"[english]SMPEvent_JumpTo"	"Scrub To"
"SMPEvent_StepFwd"	"Păşeşte în faţă"
"[english]SMPEvent_StepFwd"	"Step Forward"
"SMPEvent_StepBack"	"Pas înapoi"
"[english]SMPEvent_StepBack"	"Step Backwards"
"SMPEvent_JumpFwd"	"Sări în faţă"
"[english]SMPEvent_JumpFwd"	"Jump Forward"
"SMPEvent_JumpBack"	"Salt înapoi"
"[english]SMPEvent_JumpBack"	"Jump Backwards"
"SMPEvent_Repeat"	"Repetă"
"[english]SMPEvent_Repeat"	"Repeat"
"SMPEvent_Maximize"	"Maximizează"
"[english]SMPEvent_Maximize"	"Maximize"
"SMPEvent_Minimize"	"Ascunde"
"[english]SMPEvent_Minimize"	"Minimize"
"SMPEvent_Restore"	"Restaurează"
"[english]SMPEvent_Restore"	"Restore"
"SMPStats_UserId"	"ID utilizator:"
"[english]SMPStats_UserId"	"User Id:"
"SMPStats_Filename"	"Nume fişier:"
"[english]SMPStats_Filename"	"Filename:"
"SMPStats_EventTitle"	"Eveniment"
"[english]SMPStats_EventTitle"	"Event"
"SMPStats_TimeTitle"	"Timp (ms)"
"[english]SMPStats_TimeTitle"	"Time (ms)"
"SMPStats_PositionTitle"	"Poziţie (ms)"
"[english]SMPStats_PositionTitle"	"Position (ms)"
"SMPStats_DialogTitle"	"Preferinţe colectare date"
"[english]SMPStats_DialogTitle"	"Data Collection Preferences"
"SMPStats_DontAskAgain"	"Nu mai întreba"
"[english]SMPStats_DontAskAgain"	"Don't ask again"
"vgui_Accept"	"Accept"
"[english]vgui_Accept"	"Accept"
"vgui_Decline"	"Refuz"
"[english]vgui_Decline"	"Decline"
"vgui_TimeLeftYearOrMore"	"mai mult de 1 an"
"[english]vgui_TimeLeftYearOrMore"	"more than 1 year"
"vgui_TimeLeftDay"	"%days% zi"
"[english]vgui_TimeLeftDay"	"%days% day"
"vgui_TimeLeftDays"	"%days% zile"
"[english]vgui_TimeLeftDays"	"%days% days"
"vgui_TimeLeftDayRemaining"	"%days% zi rămasă"
"[english]vgui_TimeLeftDayRemaining"	"%days% day remaining"
"vgui_TimeLeftDaysRemaining"	"%days% zile rămase"
"[english]vgui_TimeLeftDaysRemaining"	"%days% days remaining"
"vgui_TimeLeftHour"	"%hours% oră"
"[english]vgui_TimeLeftHour"	"%hours% hour"
"vgui_TimeLeftHours"	"%hours% ore"
"[english]vgui_TimeLeftHours"	"%hours% hours"
"vgui_TimeLeftHourRemaining"	"%hours% oră rămasă"
"[english]vgui_TimeLeftHourRemaining"	"%hours% hour remaining"
"vgui_TimeLeftHoursRemaining"	"%hours% ore rămase"
"[english]vgui_TimeLeftHoursRemaining"	"%hours% hours remaining"
"vgui_TimeLeftMinute"	"%minutes% minut"
"[english]vgui_TimeLeftMinute"	"%minutes% minute"
"vgui_TimeLeftMinutes"	"%minutes% minute"
"[english]vgui_TimeLeftMinutes"	"%minutes% minutes"
"vgui_TimeLeftMinuteRemaining"	"%minutes% minut rămas"
"[english]vgui_TimeLeftMinuteRemaining"	"%minutes% minute remaining"
"vgui_TimeLeftMinutesRemaining"	"%minutes% minute rămase"
"[english]vgui_TimeLeftMinutesRemaining"	"%minutes% minutes remaining"
"vgui_TimeLeftSecond"	"%seconds% secundă"
"[english]vgui_TimeLeftSecond"	"%seconds% second"
"vgui_TimeLeftSeconds"	"%seconds% secunde"
"[english]vgui_TimeLeftSeconds"	"%seconds% seconds"
"vgui_TimeLeftSecondRemaining"	"%seconds% secundă rămasă"
"[english]vgui_TimeLeftSecondRemaining"	"%seconds% second remaining"
"vgui_TimeLeftSecondsRemaining"	"%seconds% secunde rămase"
"[english]vgui_TimeLeftSecondsRemaining"	"%seconds% seconds remaining"
"vgui_TimeLeftDaysHours"	"%days% zile %hours% ore"
"[english]vgui_TimeLeftDaysHours"	"%days% days %hours% hours"
"vgui_TimeLeftDaysHour"	"%days% zile %hours% oră"
"[english]vgui_TimeLeftDaysHour"	"%days% days %hours% hour"
"vgui_TimeLeftDayHours"	"%days% zi %hours% ore"
"[english]vgui_TimeLeftDayHours"	"%days% day %hours% hours"
"vgui_TimeLeftDayHour"	"%days% zi %hours% ore"
"[english]vgui_TimeLeftDayHour"	"%days% day %hours% hour"
"vgui_TimeLeftDaysHoursRemaining"	"%days% zile %hours% ore rămase"
"[english]vgui_TimeLeftDaysHoursRemaining"	"%days% days %hours% hours remaining"
"vgui_TimeLeftDaysHourRemaining"	"%days% zile %hours% oră rămase"
"[english]vgui_TimeLeftDaysHourRemaining"	"%days% days %hours% hour remaining"
"vgui_TimeLeftDayHoursRemaining"	"%days% zi %hours% ore rămasă"
"[english]vgui_TimeLeftDayHoursRemaining"	"%days% day %hours% hours remaining"
"vgui_TimeLeftDayHourRemaining"	"%days% zi %hours% oră rămasă"
"[english]vgui_TimeLeftDayHourRemaining"	"%days% day %hours% hour remaining"
"vgui_TimeLeftHoursMinutes"	"%hours% ore %minutes% minute"
"[english]vgui_TimeLeftHoursMinutes"	"%hours% hours %minutes% minutes"
"vgui_TimeLeftHoursMinute"	"%hours% ore %minutes% minut"
"[english]vgui_TimeLeftHoursMinute"	"%hours% hours %minutes% minute"
"vgui_TimeLeftHourMinutes"	"%hours% oră %minutes% minute"
"[english]vgui_TimeLeftHourMinutes"	"%hours% hour %minutes% minutes"
"vgui_TimeLeftHourMinute"	"%hours% oră %minutes% minut"
"[english]vgui_TimeLeftHourMinute"	"%hours% hour %minutes% minute"
"vgui_TimeLeftHoursMinutesRemaining"	"%hours% ore %minutes% minute rămase"
"[english]vgui_TimeLeftHoursMinutesRemaining"	"%hours% hours %minutes% minutes remaining"
"vgui_TimeLeftHoursMinuteRemaining"	"%hours% ore %minutes% minut rămase"
"[english]vgui_TimeLeftHoursMinuteRemaining"	"%hours% hours %minutes% minute remaining"
"vgui_TimeLeftHourMinutesRemaining"	"%hours% oră %minutes% minute rămasă"
"[english]vgui_TimeLeftHourMinutesRemaining"	"%hours% hour %minutes% minutes remaining"
"vgui_TimeLeftHourMinuteRemaining"	"%hours% oră %minutes% minut rămasă"
"[english]vgui_TimeLeftHourMinuteRemaining"	"%hours% hour %minutes% minute remaining"
"vgui_TimeLeftMinutesSeconds"	"%minutes% minute %seconds% secunde"
"[english]vgui_TimeLeftMinutesSeconds"	"%minutes% minutes %seconds% seconds"
"vgui_TimeLeftMinutesSecond"	"%minutes% minute %seconds% secundă"
"[english]vgui_TimeLeftMinutesSecond"	"%minutes% minutes %seconds% second"
"vgui_TimeLeftMinuteSeconds"	"%minutes% minut %seconds% secunde"
"[english]vgui_TimeLeftMinuteSeconds"	"%minutes% minute %seconds% seconds"
"vgui_TimeLeftMinuteSecond"	"%minutes% minut %seconds% secundă"
"[english]vgui_TimeLeftMinuteSecond"	"%minutes% minute %seconds% second"
"vgui_TimeLeftMinutesSecondsRemaining"	"%minutes% minute %seconds% secunde rămase"
"[english]vgui_TimeLeftMinutesSecondsRemaining"	"%minutes% minutes %seconds% seconds remaining"
"vgui_TimeLeftMinutesSecondRemaining"	"%minutes% minute %seconds% secundă rămase"
"[english]vgui_TimeLeftMinutesSecondRemaining"	"%minutes% minutes %seconds% second remaining"
"vgui_TimeLeftMinuteSecondsRemaining"	"%minutes% minut %seconds% secunde rămas"
"[english]vgui_TimeLeftMinuteSecondsRemaining"	"%minutes% minute %seconds% seconds remaining"
"vgui_TimeLeftMinuteSecondRemaining"	"%minutes% minut %seconds% secundă rămas"
"[english]vgui_TimeLeftMinuteSecondRemaining"	"%minutes% minute %seconds% second remaining"
"vgui_Today"	"Azi"
"[english]vgui_Today"	"Today"
"vgui_Yesterday"	"Ieri"
"[english]vgui_Yesterday"	"Yesterday"
"vgui_Tomorrow"	"Mâine"
"[english]vgui_Tomorrow"	"Tomorrow"
"vgui_OnForDays"	"Conectat de %days% zile"
"[english]vgui_OnForDays"	"On for %days% days"
"vgui_OnForHours"	"Conectat de %hours% ore"
"[english]vgui_OnForHours"	"On for %hours% hours"
"vgui_OnForMinutes"	"Conectat de %minutes% minute"
"[english]vgui_OnForMinutes"	"On for %minutes% minutes"
"vgui_OnForSeconds"	"Conectat de %seconds% secunde"
"[english]vgui_OnForSeconds"	"On for %seconds% seconds"
"vgui_OnForDay"	"Conectat de %days% zi"
"[english]vgui_OnForDay"	"On for %days% day"
"vgui_OnForHour"	"Conectat de %hours% oră"
"[english]vgui_OnForHour"	"On for %hours% hour"
"vgui_OnForMinute"	"Conectat de %minutes% minut"
"[english]vgui_OnForMinute"	"On for %minutes% minute"
"vgui_OnForSecond"	"Conectat de %seconds% secundă"
"[english]vgui_OnForSecond"	"On for %seconds% second"
"vgui_LastOnYearOrMore"	"Online ultima dată: acum mai bine de 1 an"
"[english]vgui_LastOnYearOrMore"	"Last Online: more than 1 year ago"
"vgui_LastOnDays"	"Online ultima dată: acum %days% zile"
"[english]vgui_LastOnDays"	"Last Online: %days% days ago"
"vgui_LastOnHours"	"Online ultima dată: acum %hours% ore"
"[english]vgui_LastOnHours"	"Last Online: %hours% hours ago"
"vgui_LastOnMinutes"	"Online ultima dată: acum %minutes% minute"
"[english]vgui_LastOnMinutes"	"Last Online: %minutes% minutes ago"
"vgui_LastOnSeconds"	"Online ultima dată: acum %seconds% secunde"
"[english]vgui_LastOnSeconds"	"Last Online: %seconds% seconds ago"
"vgui_LastOnDay"	"Online ultima dată: acum %days% zi"
"[english]vgui_LastOnDay"	"Last Online: %days% day ago"
"vgui_LastOnHour"	"Online ultima dată: acum %hours% oră"
"[english]vgui_LastOnHour"	"Last Online: %hours% hour ago"
"vgui_LastOnMinute"	"Online ultima dată: acum %minutes% minut"
"[english]vgui_LastOnMinute"	"Last Online: %minutes% minute ago"
"vgui_LastOnSecond"	"Online ultima dată: acum %seconds% secunde"
"[english]vgui_LastOnSecond"	"Last Online: %seconds% second ago"
"vgui_TimeAgoYearOrMore"	"acum 1 an"
"[english]vgui_TimeAgoYearOrMore"	"more than 1 year ago"
"vgui_TimeAgoDays"	"acum %days% zile"
"[english]vgui_TimeAgoDays"	"%days% days ago"
"vgui_TimeAgoHours"	"acum %hours% ore"
"[english]vgui_TimeAgoHours"	"%hours% hours ago"
"vgui_TimeAgoMinutes"	"acum %minutes% minute"
"[english]vgui_TimeAgoMinutes"	"%minutes% minutes ago"
"vgui_TimeAgoSeconds"	"acum %seconds% secunde"
"[english]vgui_TimeAgoSeconds"	"%seconds% seconds ago"
"vgui_TimeAgoDay"	"acum %days% zi"
"[english]vgui_TimeAgoDay"	"%days% day ago"
"vgui_TimeAgoHour"	"acum %hours% oră"
"[english]vgui_TimeAgoHour"	"%hours% hour ago"
"vgui_TimeAgoMinute"	"acum %minutes% minut"
"[english]vgui_TimeAgoMinute"	"%minutes% minute ago"
"vgui_TimeAgoSecond"	"acum %seconds% secundă"
"[english]vgui_TimeAgoSecond"	"%seconds% second ago"
"FileOpenDialog_Col_Name"	"Nume"
"[english]FileOpenDialog_Col_Name"	"Name"
"FileOpenDialog_Col_Size"	"Dimensiune"
"[english]FileOpenDialog_Col_Size"	"Size"
"FileOpenDialog_Col_Type"	"Tip"
"[english]FileOpenDialog_Col_Type"	"Type"
"FileOpenDialog_Col_DateModified"	"Data modificării"
"[english]FileOpenDialog_Col_DateModified"	"Date Modified"
"FileOpenDialog_Col_DateCreated"	"Data creării"
"[english]FileOpenDialog_Col_DateCreated"	"Date Created"
"FileOpenDialog_Col_Attributes"	"Atribute"
"[english]FileOpenDialog_Col_Attributes"	"Attributes"
"FileOpenDialog_FileType_Folder"	"Director de fişiere"
"[english]FileOpenDialog_FileType_Folder"	"File Folder"
"FileOpenDialog_ToolTip_Up"	"Sus"
"[english]FileOpenDialog_ToolTip_Up"	"Up"
"FileOpenDialog_ToolTip_NewFolder"	"Folder nou"
"[english]FileOpenDialog_ToolTip_NewFolder"	"New Folder"
"FileOpenDialog_NewFolder_InputTitle"	"Folder nou"
"[english]FileOpenDialog_NewFolder_InputTitle"	"New Folder"
"FileOpenDialog_NewFolderPrompt"	"Nume:"
"[english]FileOpenDialog_NewFolderPrompt"	"Name:"
"FileOpenDialog_NewFolder_DefaultName"	"Folder nou"
"[english]FileOpenDialog_NewFolder_DefaultName"	"New Folder"
"vgui_Webkit_error_title"	"Eroare"
"[english]vgui_Webkit_error_title"	"Error"
"vgui_Webkit_pagetypeunsupported"	"Pagina nu a putut fi încărcată, formatul paginii este nevalid"
"[english]vgui_Webkit_pagetypeunsupported"	"Unable to load page, unsupported page format"
"vgui_Webkit_cachemiss"	"Perioada de valabilitate a formularului a expirat. Clic pentru a retrimite datele introduse."
"[english]vgui_Webkit_cachemiss"	"Your form request has expired. Click reload to re-submit the form data."
"vgui_Webkit_badurl"	"URL-ul nu a putut fi încărcat, hostname sau format nevalid"
"[english]vgui_Webkit_badurl"	"Unable to load URL, bad hostname or format"
"vgui_Webkit_connectionproblem"	"Nu s-a putut stabili o conexiune cu serverul, e posibil ca acesta să nu fie online sau să nu existe legătură la Internet."
"[english]vgui_Webkit_connectionproblem"	"Unable to connect to server. Server may be offline or you may not be connected to the internet."
"vgui_Webkit_unknown"	"Pagina nu a putut fi încărcată (eroare necunoscută)."
"[english]vgui_Webkit_unknown"	"Failed to load web page (unknown error)."
"vgui_HTMLBack"	"Înapoi"
"[english]vgui_HTMLBack"	"Back"
"vgui_HTMLForward"	"Înainte"
"[english]vgui_HTMLForward"	"Forward"
"vgui_HTMLReload"	"Reîncarcă"
"[english]vgui_HTMLReload"	"Reload"
"vgui_HTMLStop"	"Stop"
"[english]vgui_HTMLStop"	"Stop"
"vgui_HTMLViewSource"	"Vezi sursa..."
"[english]vgui_HTMLViewSource"	"View Source..."
"vgui_Webkit_error_header"	"Cod de eroare:"
"[english]vgui_Webkit_error_header"	"Error Code: "
"vgui_Webkit_proxyconnectionproblem"	"Nu s-a putut realiza o conexiune la Proxy HTTP. Proxy-ul domneavoastră poate fi configurat greşit sau este offline."
"[english]vgui_Webkit_proxyconnectionproblem"	"Unable to connect to HTTP Proxy. Your proxy may be misconfigured or offline."
"vgui_HTMLCopyUrl"	"Copiază URL-ul paginii"
"[english]vgui_HTMLCopyUrl"	"Copy Page URL"
"vgui_HTMLCopyLink"	"Copiază adresa linkului"
"[english]vgui_HTMLCopyLink"	"Copy Link Address"
"vgui_HTMLSearchMatch"	"%findactive% din %findcount%"
"[english]vgui_HTMLSearchMatch"	"%findactive% of %findcount%"
"vgui_HTMLSearchThisPage"	"Caută în pagină"
"[english]vgui_HTMLSearchThisPage"	"Search this page"
"vgui_choosedirectoryname"	"Alege numele directorului"
"[english]vgui_choosedirectoryname"	"Choose directory name"
"TextEntry_CopyAllToClipboard"	"Copiază textul în memoria temporară"
"[english]TextEntry_CopyAllToClipboard"	"Copy all text to clipboard"
"vgui_yes"	"Da"
"[english]vgui_yes"	"Yes"
"vgui_no"	"Nu"
"[english]vgui_no"	"No"
"vgui_HTMLCloseDevTools"	"Închide instrumentele de dezvoltare"
"[english]vgui_HTMLCloseDevTools"	"Close Developer Tools"
"vgui_HTMLOpenDevTools"	"Deschide instrumentele de dezvoltare"
"[english]vgui_HTMLOpenDevTools"	"Open Developer Tools"
"vgui_continue"	"Continuă"
"[english]vgui_continue"	"Continue"
"vgui_ShuttingDown"	"Se închide..."
"[english]vgui_ShuttingDown"	"Shutting down..."
}
}
