"lang"
{
"Language"	"vietnamese"
"Tokens"
{
"TextEntry_Cut"	"Cắt"
"[english]TextEntry_Cut"	"Cut"
"TextEntry_Copy"	"Sao chép"
"[english]TextEntry_Copy"	"Copy"
"TextEntry_Paste"	"Dán"
"[english]TextEntry_Paste"	"Paste"
"TextEntry_SelectAll"	"Chọn tất cả"
"[english]TextEntry_SelectAll"	"Select all"
"FileOpenDialog_Open"	"Mở"
"[english]FileOpenDialog_Open"	"Open"
"FileOpenDialog_Cancel"	"Hủy"
"[english]FileOpenDialog_Cancel"	"Cancel"
"FileOpenDialog_Look_in"	"Tìm:"
"[english]FileOpenDialog_Look_in"	"Look in:"
"FileOpenDialog_File_Name"	"Tên tệp:"
"[english]FileOpenDialog_File_Name"	"File name:"
"FileOpenDialog_File_Type"	"Loại tệp:"
"[english]FileOpenDialog_File_Type"	"File type:"
"FileOpenDialog_Icon"	" "
"[english]FileOpenDialog_Icon"	" "
"FileOpenDialog_Name"	"Tên"
"[english]FileOpenDialog_Name"	"Name"
"FileOpenDialog_Type"	"Loại"
"[english]FileOpenDialog_Type"	"Type"
"SysMenu_Minimize"	" Thu nhỏ "
"[english]SysMenu_Minimize"	" Minimize "
"SysMenu_Maximize"	" Phóng to "
"[english]SysMenu_Maximize"	" Maximize "
"SysMenu_Close"	" Đóng "
"[english]SysMenu_Close"	" Close "
"Frame_Untitled"	"Không có tiêu đề"
"[english]Frame_Untitled"	"Untitled"
"MessageBox_OK"	"OK"
"[english]MessageBox_OK"	"OK"
"PropertyDialog_OK"	"OK"
"[english]PropertyDialog_OK"	"OK"
"PropertyDialog_Cancel"	"Hủy"
"[english]PropertyDialog_Cancel"	"Cancel"
"PropertyDialog_Apply"	"Áp dụng"
"[english]PropertyDialog_Apply"	"Apply"
"QueryBox_Cancel"	"Hủy"
"[english]QueryBox_Cancel"	"Cancel"
"WizardPanel_Next"	"Tiếp >"
"[english]WizardPanel_Next"	"Next >"
"WizardPanel_Back"	"< Trước"
"[english]WizardPanel_Back"	"< Back"
"WizardPanel_Finish"	"Kết thúc"
"[english]WizardPanel_Finish"	"Finish"
"WizardPanel_Cancel"	"Hủy"
"[english]WizardPanel_Cancel"	"Cancel"
"vgui_ok"	"OK"
"[english]vgui_ok"	"OK"
"vgui_close"	"Đóng"
"[english]vgui_close"	"Close"
"vgui_Cancel"	"Hủy"
"[english]vgui_Cancel"	"Cancel"
"vgui_select"	"Chọn"
"[english]vgui_select"	"Select"
"vgui_createfolder"	"Thư mục mới..."
"[english]vgui_createfolder"	"New Folder..."
"vgui_next"	"Tiếp >"
"[english]vgui_next"	"Next >"
"vgui_back"	"< Lùi"
"[english]vgui_back"	"< Back"
"vgui_CreateDirectoryFail_Title"	"Tạo thư mục - Lỗi"
"[english]vgui_CreateDirectoryFail_Title"	"Create Folder - Error"
"vgui_CreateDirectoryFail_Info"	"Không thể tạo thư mục mới, ổ cứng này ở dạng chỉ-đọc."
"[english]vgui_CreateDirectoryFail_Info"	"Failed to create a folder, this drive is read-only."
"vgui_CreateDirectoryFail_AlreadyExists"	"Thư mục này đã tồn tại."
"[english]vgui_CreateDirectoryFail_AlreadyExists"	"That folder already exists."
"TextEntry_Language"	"Ngôn ngữ"
"[english]TextEntry_Language"	"Language"
"TextEntry_ConversionMode"	"Chế độ Chuyển đổi"
"[english]TextEntry_ConversionMode"	"Conversion Mode"
"TextEntry_SentenceMode"	"Chế độ câu"
"[english]TextEntry_SentenceMode"	"Sentence Mode"
"IME_English"	"Tiếng Anh"
"[english]IME_English"	"English"
"IME_Chinese"	"Trung Quốc"
"[english]IME_Chinese"	"Chinese"
"IME_Korean"	"Hàn Quốc"
"[english]IME_Korean"	"Korean"
"IME_Hiragana"	"Hiragana"
"[english]IME_Hiragana"	"Hiragana"
"IME_FullWidthKatakana"	"Katakana toàn giác"
"[english]IME_FullWidthKatakana"	"Full-width Katakana"
"IME_FullWidthAlphanumeric"	"Chữ và số toàn giác"
"[english]IME_FullWidthAlphanumeric"	"Full-width Alphanumeric"
"IME_HalfWidthKatakana"	"Katakana bán giác"
"[english]IME_HalfWidthKatakana"	"Half-width Katakana"
"IME_HalfWidthAlphanumeric"	"Chữ và số bán giác"
"[english]IME_HalfWidthAlphanumeric"	"Half-width Alphanumeric"
"IME_General"	"Tổng quát"
"[english]IME_General"	"General"
"IME_BiasNames"	"Tên ưa thích"
"[english]IME_BiasNames"	"Bias for Names"
"IME_BiasSpeech"	"Ngôn ngữ ưa thích"
"[english]IME_BiasSpeech"	"Bias for Speech"
"IME_NoConversion"	"Không có chuyển đổi"
"[english]IME_NoConversion"	"No Conversion"
"IME_0404"	"Tiếng Trung (Đài Loan)"
"[english]IME_0404"	"Chinese (Taiwan)"
"IME_0804"	"Tiếng Trung (Trung Quốc)"
"[english]IME_0804"	"Chinese (PRC)"
"IME_0409"	"Tiếng Anh (Hoa Kỳ)"
"[english]IME_0409"	"English (United States)"
"IME_0411"	"Nhật Bản"
"[english]IME_0411"	"Japanese"
"IME_0412"	"Hàn Quốc"
"[english]IME_0412"	"Korean"
"IME_0419"	"Tiếng Nga"
"[english]IME_0419"	"Russian"
"IME_041e"	"Tiếng Thái"
"[english]IME_041e"	"Thai"
"IME_040c"	"Tiếng Pháp (Chuẩn)"
"[english]IME_040c"	"French (Standard)"
"IME_0407"	"Tiếng Đức (Chuẩn)"
"[english]IME_0407"	"German (Standard)"
"IME_0410"	"Tiếng Ý (Chuẩn)"
"[english]IME_0410"	"Italian (Standard)"
"IME_040a"	"Tiếng Tây Ban Nha (Tây Ban Nha, Theo truyền thống)"
"[english]IME_040a"	"Spanish (Spain, Traditional Sort)"
"vgui_FileCopyDialog_Title"	"Đang sao chép..."
"[english]vgui_FileCopyDialog_Title"	"Copying..."
"vgui_FileMoveDialog_Title"	"Đang chuyển..."
"[english]vgui_FileMoveDialog_Title"	"Moving..."
"vgui_FileCopy_Estimate"	"còn %s1"
"[english]vgui_FileCopy_Estimate"	"%s1 remaining"
"vgui_FileCopy_Copying_Multiple"	"Đang sao chép '%s1' (còn %s2)"
"[english]vgui_FileCopy_Copying_Multiple"	"Copying '%s1' (%s2 remaining)"
"vgui_FileCopy_Copying_Single"	"Đang sao chép '%s1'"
"[english]vgui_FileCopy_Copying_Single"	"Copying '%s1'"
"vgui_FileCopy_Ovewwrite_Title"	"Ghi đè tệp tin"
"[english]vgui_FileCopy_Ovewwrite_Title"	"Overwrite file(s)"
"vgui_FileCopy_Ovewwrite_Prompt"	"Ghi đè '%filename%'?"
"[english]vgui_FileCopy_Ovewwrite_Prompt"	"Overwrite '%filename%'?"
"SMPEvent_AppLaunch"	"Khởi chạy ứng dụng"
"[english]SMPEvent_AppLaunch"	"App Launch"
"SMPEvent_AppExit"	"Thoát ứng dụng"
"[english]SMPEvent_AppExit"	"App Exit"
"SMPEvent_Close"	"Đóng"
"[english]SMPEvent_Close"	"Close"
"SMPEvent_FadeOut"	"Làm mờ"
"[english]SMPEvent_FadeOut"	"Fade Out"
"SMPEvent_MediaBegin"	"Bắt đầu trình chiếu"
"[english]SMPEvent_MediaBegin"	"Media Begin"
"SMPEvent_MediaEnd"	"Kết thúc trình chiếu"
"[english]SMPEvent_MediaEnd"	"Media End"
"SMPEvent_Play"	"Bắt đầu"
"[english]SMPEvent_Play"	"Play"
"SMPEvent_JumpHome"	"Đến vị trí đầu"
"[english]SMPEvent_JumpHome"	"Jump Home"
"SMPEvent_JumpEnd"	"Đến vị trí cuối"
"[english]SMPEvent_JumpEnd"	"Jump To End"
"SMPEvent_Pause"	"Tạm dừng"
"[english]SMPEvent_Pause"	"Pause"
"SMPEvent_Stop"	"Dừng"
"[english]SMPEvent_Stop"	"Stop"
"SMPEvent_JumpFrom"	"Nhảy từ"
"[english]SMPEvent_JumpFrom"	"Scrub From"
"SMPEvent_JumpTo"	"Nhảy đến"
"[english]SMPEvent_JumpTo"	"Scrub To"
"SMPEvent_StepFwd"	"Tiến tới"
"[english]SMPEvent_StepFwd"	"Step Forward"
"SMPEvent_StepBack"	"Lùi lại"
"[english]SMPEvent_StepBack"	"Step Backwards"
"SMPEvent_JumpFwd"	"Tua qua"
"[english]SMPEvent_JumpFwd"	"Jump Forward"
"SMPEvent_JumpBack"	"Tua lại"
"[english]SMPEvent_JumpBack"	"Jump Backwards"
"SMPEvent_Repeat"	"Lặp lại"
"[english]SMPEvent_Repeat"	"Repeat"
"SMPEvent_Maximize"	"Phóng to"
"[english]SMPEvent_Maximize"	"Maximize"
"SMPEvent_Minimize"	"Thu nhỏ"
"[english]SMPEvent_Minimize"	"Minimize"
"SMPEvent_Restore"	"Khôi phục"
"[english]SMPEvent_Restore"	"Restore"
"SMPStats_UserId"	"Tên tài khoản:"
"[english]SMPStats_UserId"	"User Id:"
"SMPStats_Filename"	"Tên tệp:"
"[english]SMPStats_Filename"	"Filename:"
"SMPStats_EventTitle"	"Sự kiện"
"[english]SMPStats_EventTitle"	"Event"
"SMPStats_TimeTitle"	"Thời gian (ms)"
"[english]SMPStats_TimeTitle"	"Time (ms)"
"SMPStats_PositionTitle"	"Thời điểm (ms)"
"[english]SMPStats_PositionTitle"	"Position (ms)"
"SMPStats_DialogTitle"	"Bộ sưu tập dữ liệu ưu tiên"
"[english]SMPStats_DialogTitle"	"Data Collection Preferences"
"SMPStats_DontAskAgain"	"Không hỏi lại"
"[english]SMPStats_DontAskAgain"	"Don't ask again"
"vgui_Accept"	"Chấp nhận"
"[english]vgui_Accept"	"Accept"
"vgui_Decline"	"Từ chối"
"[english]vgui_Decline"	"Decline"
"vgui_TimeLeftYearOrMore"	"hơn 1 năm"
"[english]vgui_TimeLeftYearOrMore"	"more than 1 year"
"vgui_TimeLeftDay"	"%days% ngày"
"[english]vgui_TimeLeftDay"	"%days% day"
"vgui_TimeLeftDays"	"%days% ngày"
"[english]vgui_TimeLeftDays"	"%days% days"
"vgui_TimeLeftDayRemaining"	"Còn %days% ngày"
"[english]vgui_TimeLeftDayRemaining"	"%days% day remaining"
"vgui_TimeLeftDaysRemaining"	"Còn %days% ngày"
"[english]vgui_TimeLeftDaysRemaining"	"%days% days remaining"
"vgui_TimeLeftHour"	"%hours% giờ"
"[english]vgui_TimeLeftHour"	"%hours% hour"
"vgui_TimeLeftHours"	"%hours% giờ"
"[english]vgui_TimeLeftHours"	"%hours% hours"
"vgui_TimeLeftHourRemaining"	"Còn %hours% giờ"
"[english]vgui_TimeLeftHourRemaining"	"%hours% hour remaining"
"vgui_TimeLeftHoursRemaining"	"Còn %hours% giờ"
"[english]vgui_TimeLeftHoursRemaining"	"%hours% hours remaining"
"vgui_TimeLeftMinute"	"%minutes% phút"
"[english]vgui_TimeLeftMinute"	"%minutes% minute"
"vgui_TimeLeftMinutes"	"%minutes% phút"
"[english]vgui_TimeLeftMinutes"	"%minutes% minutes"
"vgui_TimeLeftMinuteRemaining"	"Còn %minutes% phút"
"[english]vgui_TimeLeftMinuteRemaining"	"%minutes% minute remaining"
"vgui_TimeLeftMinutesRemaining"	"Còn %minutes% phút"
"[english]vgui_TimeLeftMinutesRemaining"	"%minutes% minutes remaining"
"vgui_TimeLeftSecond"	"%seconds% giây"
"[english]vgui_TimeLeftSecond"	"%seconds% second"
"vgui_TimeLeftSeconds"	"%seconds% giây"
"[english]vgui_TimeLeftSeconds"	"%seconds% seconds"
"vgui_TimeLeftSecondRemaining"	"Còn %seconds% giây"
"[english]vgui_TimeLeftSecondRemaining"	"%seconds% second remaining"
"vgui_TimeLeftSecondsRemaining"	"Còn %seconds% giây"
"[english]vgui_TimeLeftSecondsRemaining"	"%seconds% seconds remaining"
"vgui_TimeLeftDaysHours"	"%days% ngày %hours% giờ"
"[english]vgui_TimeLeftDaysHours"	"%days% days %hours% hours"
"vgui_TimeLeftDaysHour"	"%days% ngày %hours% giờ"
"[english]vgui_TimeLeftDaysHour"	"%days% days %hours% hour"
"vgui_TimeLeftDayHours"	"%days% ngày %hours% giờ"
"[english]vgui_TimeLeftDayHours"	"%days% day %hours% hours"
"vgui_TimeLeftDayHour"	"%days% ngày %hours% giờ"
"[english]vgui_TimeLeftDayHour"	"%days% day %hours% hour"
"vgui_TimeLeftDaysHoursRemaining"	"Còn %days% ngày %hours% giờ"
"[english]vgui_TimeLeftDaysHoursRemaining"	"%days% days %hours% hours remaining"
"vgui_TimeLeftDaysHourRemaining"	"Còn %days% ngày %hours% giờ"
"[english]vgui_TimeLeftDaysHourRemaining"	"%days% days %hours% hour remaining"
"vgui_TimeLeftDayHoursRemaining"	"Còn %days% ngày %hours% giờ"
"[english]vgui_TimeLeftDayHoursRemaining"	"%days% day %hours% hours remaining"
"vgui_TimeLeftDayHourRemaining"	"Còn %days% ngày %hours% giờ"
"[english]vgui_TimeLeftDayHourRemaining"	"%days% day %hours% hour remaining"
"vgui_TimeLeftHoursMinutes"	"%hours% giờ %minutes% phút"
"[english]vgui_TimeLeftHoursMinutes"	"%hours% hours %minutes% minutes"
"vgui_TimeLeftHoursMinute"	"%hours% giờ %minutes% phút"
"[english]vgui_TimeLeftHoursMinute"	"%hours% hours %minutes% minute"
"vgui_TimeLeftHourMinutes"	"%hours% giờ %minutes% phút"
"[english]vgui_TimeLeftHourMinutes"	"%hours% hour %minutes% minutes"
"vgui_TimeLeftHourMinute"	"%hours% giờ %minutes% phút"
"[english]vgui_TimeLeftHourMinute"	"%hours% hour %minutes% minute"
"vgui_TimeLeftHoursMinutesRemaining"	"Còn %hours% giờ %minutes% phút"
"[english]vgui_TimeLeftHoursMinutesRemaining"	"%hours% hours %minutes% minutes remaining"
"vgui_TimeLeftHoursMinuteRemaining"	"Còn %hours% giờ %minutes% phút"
"[english]vgui_TimeLeftHoursMinuteRemaining"	"%hours% hours %minutes% minute remaining"
"vgui_TimeLeftHourMinutesRemaining"	"Còn %hours% giờ %minutes% phút"
"[english]vgui_TimeLeftHourMinutesRemaining"	"%hours% hour %minutes% minutes remaining"
"vgui_TimeLeftHourMinuteRemaining"	"Còn %hours% giờ %minutes% phút"
"[english]vgui_TimeLeftHourMinuteRemaining"	"%hours% hour %minutes% minute remaining"
"vgui_TimeLeftMinutesSeconds"	"%minutes% phút %seconds% giây"
"[english]vgui_TimeLeftMinutesSeconds"	"%minutes% minutes %seconds% seconds"
"vgui_TimeLeftMinutesSecond"	"%minutes% phút %seconds% giây"
"[english]vgui_TimeLeftMinutesSecond"	"%minutes% minutes %seconds% second"
"vgui_TimeLeftMinuteSeconds"	"%minutes% phút %seconds% giây"
"[english]vgui_TimeLeftMinuteSeconds"	"%minutes% minute %seconds% seconds"
"vgui_TimeLeftMinuteSecond"	"%minutes% phút %seconds% giây"
"[english]vgui_TimeLeftMinuteSecond"	"%minutes% minute %seconds% second"
"vgui_TimeLeftMinutesSecondsRemaining"	"Còn %minutes% phút %seconds% giây"
"[english]vgui_TimeLeftMinutesSecondsRemaining"	"%minutes% minutes %seconds% seconds remaining"
"vgui_TimeLeftMinutesSecondRemaining"	"Còn %minutes% phút %seconds% giây"
"[english]vgui_TimeLeftMinutesSecondRemaining"	"%minutes% minutes %seconds% second remaining"
"vgui_TimeLeftMinuteSecondsRemaining"	"Còn %minutes% phút %seconds% giây"
"[english]vgui_TimeLeftMinuteSecondsRemaining"	"%minutes% minute %seconds% seconds remaining"
"vgui_TimeLeftMinuteSecondRemaining"	"Còn %minutes% phút %seconds% giây"
"[english]vgui_TimeLeftMinuteSecondRemaining"	"%minutes% minute %seconds% second remaining"
"vgui_Today"	"Hôm nay"
"[english]vgui_Today"	"Today"
"vgui_Yesterday"	"Hôm qua"
"[english]vgui_Yesterday"	"Yesterday"
"vgui_Tomorrow"	"Ngày mai"
"[english]vgui_Tomorrow"	"Tomorrow"
"vgui_OnForDays"	"Đã trên mạng được %days% ngày"
"[english]vgui_OnForDays"	"On for %days% days"
"vgui_OnForHours"	"Đã trên mạng được %hours% giờ"
"[english]vgui_OnForHours"	"On for %hours% hours"
"vgui_OnForMinutes"	"Đã trên mạng được %minutes% phút"
"[english]vgui_OnForMinutes"	"On for %minutes% minutes"
"vgui_OnForSeconds"	"Đã trên mạng được %seconds% giây"
"[english]vgui_OnForSeconds"	"On for %seconds% seconds"
"vgui_OnForDay"	"Đã trên mạng được %days% ngày"
"[english]vgui_OnForDay"	"On for %days% day"
"vgui_OnForHour"	"Đã trên mạng được %hours% giờ"
"[english]vgui_OnForHour"	"On for %hours% hour"
"vgui_OnForMinute"	"Đã trên mạng được %minutes% phút"
"[english]vgui_OnForMinute"	"On for %minutes% minute"
"vgui_OnForSecond"	"Đã trên mạng được %seconds% giây"
"[english]vgui_OnForSecond"	"On for %seconds% second"
"vgui_LastOnYearOrMore"	"Lần cuối trên mạng: hơn 1 năm trước"
"[english]vgui_LastOnYearOrMore"	"Last Online: more than 1 year ago"
"vgui_LastOnDays"	"Lần cuối trên mạng: %days% ngày trước"
"[english]vgui_LastOnDays"	"Last Online: %days% days ago"
"vgui_LastOnHours"	"Lần cuối trên mạng: %hours% giờ trước"
"[english]vgui_LastOnHours"	"Last Online: %hours% hours ago"
"vgui_LastOnMinutes"	"Lần cuối trên mạng: %minutes% phút trước"
"[english]vgui_LastOnMinutes"	"Last Online: %minutes% minutes ago"
"vgui_LastOnSeconds"	"Lần cuối trên mạng: %seconds% giây trước"
"[english]vgui_LastOnSeconds"	"Last Online: %seconds% seconds ago"
"vgui_LastOnDay"	"Lần cuối trên mạng: %days% ngày trước"
"[english]vgui_LastOnDay"	"Last Online: %days% day ago"
"vgui_LastOnHour"	"Lần cuối trên mạng: %hours% giờ trước"
"[english]vgui_LastOnHour"	"Last Online: %hours% hour ago"
"vgui_LastOnMinute"	"Lần cuối trên mạng: %minutes% phút trước"
"[english]vgui_LastOnMinute"	"Last Online: %minutes% minute ago"
"vgui_LastOnSecond"	"Lần cuối trên mạng: %seconds% giây trước"
"[english]vgui_LastOnSecond"	"Last Online: %seconds% second ago"
"vgui_TimeAgoYearOrMore"	"hơn 1 năm trước"
"[english]vgui_TimeAgoYearOrMore"	"more than 1 year ago"
"vgui_TimeAgoDays"	"%days% ngày trước"
"[english]vgui_TimeAgoDays"	"%days% days ago"
"vgui_TimeAgoHours"	"%hours% giờ trước"
"[english]vgui_TimeAgoHours"	"%hours% hours ago"
"vgui_TimeAgoMinutes"	"%minutes% phút trước"
"[english]vgui_TimeAgoMinutes"	"%minutes% minutes ago"
"vgui_TimeAgoSeconds"	"%seconds% giây trước"
"[english]vgui_TimeAgoSeconds"	"%seconds% seconds ago"
"vgui_TimeAgoDay"	"%days% ngày trước"
"[english]vgui_TimeAgoDay"	"%days% day ago"
"vgui_TimeAgoHour"	"%hours% giờ trước"
"[english]vgui_TimeAgoHour"	"%hours% hour ago"
"vgui_TimeAgoMinute"	"%minutes% phút trước"
"[english]vgui_TimeAgoMinute"	"%minutes% minute ago"
"vgui_TimeAgoSecond"	"%seconds% giây trước"
"[english]vgui_TimeAgoSecond"	"%seconds% second ago"
"FileOpenDialog_Col_Name"	"Tên"
"[english]FileOpenDialog_Col_Name"	"Name"
"FileOpenDialog_Col_Size"	"Kích cỡ"
"[english]FileOpenDialog_Col_Size"	"Size"
"FileOpenDialog_Col_Type"	"Loại"
"[english]FileOpenDialog_Col_Type"	"Type"
"FileOpenDialog_Col_DateModified"	"Ngày sửa cuối"
"[english]FileOpenDialog_Col_DateModified"	"Date Modified"
"FileOpenDialog_Col_DateCreated"	"Ngày tạo"
"[english]FileOpenDialog_Col_DateCreated"	"Date Created"
"FileOpenDialog_Col_Attributes"	"Chỉ số"
"[english]FileOpenDialog_Col_Attributes"	"Attributes"
"FileOpenDialog_FileType_Folder"	"Thư mục tập tin"
"[english]FileOpenDialog_FileType_Folder"	"File Folder"
"FileOpenDialog_ToolTip_Up"	"Lên"
"[english]FileOpenDialog_ToolTip_Up"	"Up"
"FileOpenDialog_ToolTip_NewFolder"	"Thư mục mới"
"[english]FileOpenDialog_ToolTip_NewFolder"	"New Folder"
"FileOpenDialog_NewFolder_InputTitle"	"Thư mục mới"
"[english]FileOpenDialog_NewFolder_InputTitle"	"New Folder"
"FileOpenDialog_NewFolderPrompt"	"Tên:"
"[english]FileOpenDialog_NewFolderPrompt"	"Name:"
"FileOpenDialog_NewFolder_DefaultName"	"Thư mục mới"
"[english]FileOpenDialog_NewFolder_DefaultName"	"New Folder"
"vgui_Webkit_error_title"	"Lỗi"
"[english]vgui_Webkit_error_title"	"Error"
"vgui_Webkit_pagetypeunsupported"	"Không thể tải trang, định dạng trang không được hỗ trợ"
"[english]vgui_Webkit_pagetypeunsupported"	"Unable to load page, unsupported page format"
"vgui_Webkit_cachemiss"	"Yêu cầu của bạn đã hết thời gian. Nhấn tải lại để gửi lại mẫu dữ liệu."
"[english]vgui_Webkit_cachemiss"	"Your form request has expired. Click reload to re-submit the form data."
"vgui_Webkit_badurl"	"Không thể tải trang URL, tên và định dạng máy chủ không đúng"
"[english]vgui_Webkit_badurl"	"Unable to load URL, bad hostname or format"
"vgui_Webkit_connectionproblem"	"Không thể kết nối tới máy chủ. Máy chủ có thể đang ngoại tuyến hoặc bạn đang không kết nối tới internet."
"[english]vgui_Webkit_connectionproblem"	"Unable to connect to server. Server may be offline or you may not be connected to the internet."
"vgui_Webkit_unknown"	"Tải trang không thành công (lỗi không xác định)."
"[english]vgui_Webkit_unknown"	"Failed to load web page (unknown error)."
"vgui_HTMLBack"	"Quay lại"
"[english]vgui_HTMLBack"	"Back"
"vgui_HTMLForward"	"Tiến tới"
"[english]vgui_HTMLForward"	"Forward"
"vgui_HTMLReload"	"Tải lại"
"[english]vgui_HTMLReload"	"Reload"
"vgui_HTMLStop"	"Dừng"
"[english]vgui_HTMLStop"	"Stop"
"vgui_HTMLViewSource"	"Xem nguồn..."
"[english]vgui_HTMLViewSource"	"View Source..."
"vgui_Webkit_error_header"	"Mã lỗi: "
"[english]vgui_Webkit_error_header"	"Error Code: "
"vgui_Webkit_proxyconnectionproblem"	"Không thể kết nối đến HTTP Proxy. Proxy của bạn có thể bị cấu hình sai hoặc ngoại tuyến."
"[english]vgui_Webkit_proxyconnectionproblem"	"Unable to connect to HTTP Proxy. Your proxy may be misconfigured or offline."
"vgui_HTMLCopyUrl"	"Sao chép địa chỉ trang web"
"[english]vgui_HTMLCopyUrl"	"Copy Page URL"
"vgui_HTMLCopyLink"	"Sao chép địa chỉ trang"
"[english]vgui_HTMLCopyLink"	"Copy Link Address"
"vgui_HTMLSearchMatch"	"%findactive% của %findcount%"
"[english]vgui_HTMLSearchMatch"	"%findactive% of %findcount%"
"vgui_HTMLSearchThisPage"	"Tìm kiếm trong trang"
"[english]vgui_HTMLSearchThisPage"	"Search this page"
"vgui_choosedirectoryname"	"Chọn tên thư mục"
"[english]vgui_choosedirectoryname"	"Choose directory name"
"TextEntry_CopyAllToClipboard"	"Sao chép toàn bộ vào khay nhớ tạm"
"[english]TextEntry_CopyAllToClipboard"	"Copy all text to clipboard"
"vgui_yes"	"Có"
"[english]vgui_yes"	"Yes"
"vgui_no"	"Không"
"[english]vgui_no"	"No"
"vgui_HTMLCloseDevTools"	"Đóng công cụ phát triển"
"[english]vgui_HTMLCloseDevTools"	"Close Developer Tools"
"vgui_HTMLOpenDevTools"	"Mở công cụ phát triển"
"[english]vgui_HTMLOpenDevTools"	"Open Developer Tools"
"vgui_continue"	"Tiếp tục"
"[english]vgui_continue"	"Continue"
"vgui_ShuttingDown"	"Đang tắt..."
"[english]vgui_ShuttingDown"	"Shutting down..."
"vgui_HTMLInspectElement"	"Kiểm tra Element"
"[english]vgui_HTMLInspectElement"	"Inspect Element"
}
}
